ALL_EVENTS	$ALL_EVENTS	$ALL_EVENTS	A Built-in Variable: ALL_EVENTS
ALL_GROUPS	$ALL_GROUPS	$ALL_GROUPS	A Built-in Variable: ALL_GROUPS
CC_NUM	$CC_NUM	$CC_NUM	A Built-in Variable: CC_NUM
CONTROL_PAR_ALLOW_AUTOMATION	$CONTROL_PAR_ALLOW_AUTOMATION	$CONTROL_PAR_ALLOW_AUTOMATION	A Built-in Variable: CONTROL_PAR_ALLOW_AUTOMATION
CONTROL_PAR_AUTOMATION_ID	$CONTROL_PAR_AUTOMATION_ID	$CONTROL_PAR_AUTOMATION_ID	A Built-in Variable: CONTROL_PAR_AUTOMATION_ID
CONTROL_PAR_AUTOMATION_NAME	$CONTROL_PAR_AUTOMATION_NAME	$CONTROL_PAR_AUTOMATION_NAME	A Built-in Variable: CONTROL_PAR_AUTOMATION_NAME
CONTROL_PAR_BAR_COLOR	$CONTROL_PAR_BAR_COLOR	$CONTROL_PAR_BAR_COLOR	A Built-in Variable: CONTROL_PAR_BAR_COLOR
CONTROL_PAR_BASEPATH	$CONTROL_PAR_BASEPATH	$CONTROL_PAR_BASEPATH	A Built-in Variable: CONTROL_PAR_BASEPATH
CONTROL_PAR_BG_COLOR	$CONTROL_PAR_BG_COLOR	$CONTROL_PAR_BG_COLOR	A Built-in Variable: CONTROL_PAR_BG_COLOR
CONTROL_PAR_COLUMN_WIDTH	$CONTROL_PAR_COLUMN_WIDTH	$CONTROL_PAR_COLUMN_WIDTH	A Built-in Variable: CONTROL_PAR_COLUMN_WIDTH
CONTROL_PAR_DEFAULT_VALUE	$CONTROL_PAR_DEFAULT_VALUE	$CONTROL_PAR_DEFAULT_VALUE	A Built-in Variable: CONTROL_PAR_DEFAULT_VALUE
CONTROL_PAR_DND_BEHAVIOUR	$CONTROL_PAR_DND_BEHAVIOUR	$CONTROL_PAR_DND_BEHAVIOUR	A Built-in Variable: CONTROL_PAR_DND_BEHAVIOUR
CONTROL_PAR_FILEPATH	$CONTROL_PAR_FILEPATH	$CONTROL_PAR_FILEPATH	A Built-in Variable: CONTROL_PAR_FILEPATH
CONTROL_PAR_FILE_TYPE	$CONTROL_PAR_FILE_TYPE	$CONTROL_PAR_FILE_TYPE	A Built-in Variable: CONTROL_PAR_FILE_TYPE
CONTROL_PAR_FONT_TYPE	$CONTROL_PAR_FONT_TYPE	$CONTROL_PAR_FONT_TYPE	A Built-in Variable: CONTROL_PAR_FONT_TYPE
CONTROL_PAR_GRID_HEIGHT	$CONTROL_PAR_GRID_HEIGHT	$CONTROL_PAR_GRID_HEIGHT	A Built-in Variable: CONTROL_PAR_GRID_HEIGHT
CONTROL_PAR_GRID_WIDTH	$CONTROL_PAR_GRID_WIDTH	$CONTROL_PAR_GRID_WIDTH	A Built-in Variable: CONTROL_PAR_GRID_WIDTH
CONTROL_PAR_GRID_X	$CONTROL_PAR_GRID_X	$CONTROL_PAR_GRID_X	A Built-in Variable: CONTROL_PAR_GRID_X
CONTROL_PAR_GRID_Y	$CONTROL_PAR_GRID_Y	$CONTROL_PAR_GRID_Y	A Built-in Variable: CONTROL_PAR_GRID_Y
CONTROL_PAR_HEIGHT	$CONTROL_PAR_HEIGHT	$CONTROL_PAR_HEIGHT	A Built-in Variable: CONTROL_PAR_HEIGHT
CONTROL_PAR_HELP	$CONTROL_PAR_HELP	$CONTROL_PAR_HELP	A Built-in Variable: CONTROL_PAR_HELP
CONTROL_PAR_HIDE	$CONTROL_PAR_HIDE	$CONTROL_PAR_HIDE	A Built-in Variable: CONTROL_PAR_HIDE
CONTROL_PAR_KEY_ALT	$CONTROL_PAR_KEY_ALT	$CONTROL_PAR_KEY_ALT	A Built-in Variable: CONTROL_PAR_KEY_ALT
CONTROL_PAR_KEY_CONTROL	$CONTROL_PAR_KEY_CONTROL	$CONTROL_PAR_KEY_CONTROL	A Built-in Variable: CONTROL_PAR_KEY_CONTROL
CONTROL_PAR_KEY_SHIFT	$CONTROL_PAR_KEY_SHIFT	$CONTROL_PAR_KEY_SHIFT	A Built-in Variable: CONTROL_PAR_KEY_SHIFT
CONTROL_PAR_LABEL	$CONTROL_PAR_LABEL	$CONTROL_PAR_LABEL	A Built-in Variable: CONTROL_PAR_LABEL
CONTROL_PAR_MAX_VALUE	$CONTROL_PAR_MAX_VALUE	$CONTROL_PAR_MAX_VALUE	A Built-in Variable: CONTROL_PAR_MAX_VALUE
CONTROL_PAR_MIN_VALUE	$CONTROL_PAR_MIN_VALUE	$CONTROL_PAR_MIN_VALUE	A Built-in Variable: CONTROL_PAR_MIN_VALUE
CONTROL_PAR_MOUSE_BEHAVIOUR	$CONTROL_PAR_MOUSE_BEHAVIOUR	$CONTROL_PAR_MOUSE_BEHAVIOUR	A Built-in Variable: CONTROL_PAR_MOUSE_BEHAVIOUR
CONTROL_PAR_NONE	$CONTROL_PAR_NONE	$CONTROL_PAR_NONE	A Built-in Variable: CONTROL_PAR_NONE
CONTROL_PAR_NUM_ITEMS	$CONTROL_PAR_NUM_ITEMS	$CONTROL_PAR_NUM_ITEMS	A Built-in Variable: CONTROL_PAR_NUM_ITEMS
CONTROL_PAR_OFF_COLOR	$CONTROL_PAR_OFF_COLOR	$CONTROL_PAR_OFF_COLOR	A Built-in Variable: CONTROL_PAR_OFF_COLOR
CONTROL_PAR_ON_COLOR	$CONTROL_PAR_ON_COLOR	$CONTROL_PAR_ON_COLOR	A Built-in Variable: CONTROL_PAR_ON_COLOR
CONTROL_PAR_OVERLOAD_COLOR	$CONTROL_PAR_OVERLOAD_COLOR	$CONTROL_PAR_OVERLOAD_COLOR	A Built-in Variable: CONTROL_PAR_OVERLOAD_COLOR
CONTROL_PAR_PEAK_COLOR	$CONTROL_PAR_PEAK_COLOR	$CONTROL_PAR_PEAK_COLOR	A Built-in Variable: CONTROL_PAR_PEAK_COLOR
CONTROL_PAR_PICTURE	$CONTROL_PAR_PICTURE	$CONTROL_PAR_PICTURE	A Built-in Variable: CONTROL_PAR_PICTURE
CONTROL_PAR_PICTURE_STATE	$CONTROL_PAR_PICTURE_STATE	$CONTROL_PAR_PICTURE_STATE	A Built-in Variable: CONTROL_PAR_PICTURE_STATE
CONTROL_PAR_POS_X	$CONTROL_PAR_POS_X	$CONTROL_PAR_POS_X	A Built-in Variable: CONTROL_PAR_POS_X
CONTROL_PAR_POS_Y	$CONTROL_PAR_POS_Y	$CONTROL_PAR_POS_Y	A Built-in Variable: CONTROL_PAR_POS_Y
CONTROL_PAR_SELECTED_ITEM_IDX	$CONTROL_PAR_SELECTED_ITEM_IDX	$CONTROL_PAR_SELECTED_ITEM_IDX	A Built-in Variable: CONTROL_PAR_SELECTED_ITEM_IDX
CONTROL_PAR_SHOW_ARROWS	$CONTROL_PAR_SHOW_ARROWS	$CONTROL_PAR_SHOW_ARROWS	A Built-in Variable: CONTROL_PAR_SHOW_ARROWS
CONTROL_PAR_TEXT	$CONTROL_PAR_TEXT	$CONTROL_PAR_TEXT	A Built-in Variable: CONTROL_PAR_TEXT
CONTROL_PAR_TEXTLINE	$CONTROL_PAR_TEXTLINE	$CONTROL_PAR_TEXTLINE	A Built-in Variable: CONTROL_PAR_TEXTLINE
CONTROL_PAR_TEXTPOS_Y	$CONTROL_PAR_TEXTPOS_Y	$CONTROL_PAR_TEXTPOS_Y	A Built-in Variable: CONTROL_PAR_TEXTPOS_Y
CONTROL_PAR_TEXT_ALIGNMENT	$CONTROL_PAR_TEXT_ALIGNMENT	$CONTROL_PAR_TEXT_ALIGNMENT	A Built-in Variable: CONTROL_PAR_TEXT_ALIGNMENT
CONTROL_PAR_UNIT	$CONTROL_PAR_UNIT	$CONTROL_PAR_UNIT	A Built-in Variable: CONTROL_PAR_UNIT
CONTROL_PAR_VALUE	$CONTROL_PAR_VALUE	$CONTROL_PAR_VALUE	A Built-in Variable: CONTROL_PAR_VALUE
CONTROL_PAR_VERTICAL	$CONTROL_PAR_VERTICAL	$CONTROL_PAR_VERTICAL	A Built-in Variable: CONTROL_PAR_VERTICAL
CONTROL_PAR_WIDTH	$CONTROL_PAR_WIDTH	$CONTROL_PAR_WIDTH	A Built-in Variable: CONTROL_PAR_WIDTH
CONTROL_PAR_ZERO_LINE_COLOR	$CONTROL_PAR_ZERO_LINE_COLOR	$CONTROL_PAR_ZERO_LINE_COLOR	A Built-in Variable: CONTROL_PAR_ZERO_LINE_COLOR
CURRENT_EVENT	$CURRENT_EVENT	$CURRENT_EVENT	A Built-in Variable: CURRENT_EVENT
CURRENT_SCRIPT_SLOT	$CURRENT_SCRIPT_SLOT	$CURRENT_SCRIPT_SLOT	A Built-in Variable: CURRENT_SCRIPT_SLOT
DISTANCE_BAR_START	$DISTANCE_BAR_START	$DISTANCE_BAR_START	A Built-in Variable: DISTANCE_BAR_START
DURATION_BAR	$DURATION_BAR	$DURATION_BAR	A Built-in Variable: DURATION_BAR
DURATION_EIGHTH	$DURATION_EIGHTH	$DURATION_EIGHTH	A Built-in Variable: DURATION_EIGHTH
DURATION_EIGHTH_TRIPLET	$DURATION_EIGHTH_TRIPLET	$DURATION_EIGHTH_TRIPLET	A Built-in Variable: DURATION_EIGHTH_TRIPLET
DURATION_QUARTER	$DURATION_QUARTER	$DURATION_QUARTER	A Built-in Variable: DURATION_QUARTER
DURATION_QUARTER_TRIPLET	$DURATION_QUARTER_TRIPLET	$DURATION_QUARTER_TRIPLET	A Built-in Variable: DURATION_QUARTER_TRIPLET
DURATION_SIXTEENTH	$DURATION_SIXTEENTH	$DURATION_SIXTEENTH	A Built-in Variable: DURATION_SIXTEENTH
DURATION_SIXTEENTH_TRIPLET	$DURATION_SIXTEENTH_TRIPLET	$DURATION_SIXTEENTH_TRIPLET	A Built-in Variable: DURATION_SIXTEENTH_TRIPLET
EFFECT_TYPE_AET_FILTER	$EFFECT_TYPE_AET_FILTER	$EFFECT_TYPE_AET_FILTER	A Built-in Variable: EFFECT_TYPE_AET_FILTER
EFFECT_TYPE_BUS_COMP	$EFFECT_TYPE_BUS_COMP	$EFFECT_TYPE_BUS_COMP	A Built-in Variable: EFFECT_TYPE_BUS_COMP
EFFECT_TYPE_CABINET	$EFFECT_TYPE_CABINET	$EFFECT_TYPE_CABINET	A Built-in Variable: EFFECT_TYPE_CABINET
EFFECT_TYPE_CHORUS	$EFFECT_TYPE_CHORUS	$EFFECT_TYPE_CHORUS	A Built-in Variable: EFFECT_TYPE_CHORUS
EFFECT_TYPE_COMPRESSOR	$EFFECT_TYPE_COMPRESSOR	$EFFECT_TYPE_COMPRESSOR	A Built-in Variable: EFFECT_TYPE_COMPRESSOR
EFFECT_TYPE_DELAY	$EFFECT_TYPE_DELAY	$EFFECT_TYPE_DELAY	A Built-in Variable: EFFECT_TYPE_DELAY
EFFECT_TYPE_DISTORTION	$EFFECT_TYPE_DISTORTION	$EFFECT_TYPE_DISTORTION	A Built-in Variable: EFFECT_TYPE_DISTORTION
EFFECT_TYPE_FB_COMP	$EFFECT_TYPE_FB_COMP	$EFFECT_TYPE_FB_COMP	A Built-in Variable: EFFECT_TYPE_FB_COMP
EFFECT_TYPE_FILTER	$EFFECT_TYPE_FILTER	$EFFECT_TYPE_FILTER	A Built-in Variable: EFFECT_TYPE_FILTER
EFFECT_TYPE_FLANGER	$EFFECT_TYPE_FLANGER	$EFFECT_TYPE_FLANGER	A Built-in Variable: EFFECT_TYPE_FLANGER
EFFECT_TYPE_GAINER	$EFFECT_TYPE_GAINER	$EFFECT_TYPE_GAINER	A Built-in Variable: EFFECT_TYPE_GAINER
EFFECT_TYPE_INVERTER	$EFFECT_TYPE_INVERTER	$EFFECT_TYPE_INVERTER	A Built-in Variable: EFFECT_TYPE_INVERTER
EFFECT_TYPE_IRC	$EFFECT_TYPE_IRC	$EFFECT_TYPE_IRC	A Built-in Variable: EFFECT_TYPE_IRC
EFFECT_TYPE_JUMP	$EFFECT_TYPE_JUMP	$EFFECT_TYPE_JUMP	A Built-in Variable: EFFECT_TYPE_JUMP
EFFECT_TYPE_LIMITER	$EFFECT_TYPE_LIMITER	$EFFECT_TYPE_LIMITER	A Built-in Variable: EFFECT_TYPE_LIMITER
EFFECT_TYPE_LOFI	$EFFECT_TYPE_LOFI	$EFFECT_TYPE_LOFI	A Built-in Variable: EFFECT_TYPE_LOFI
EFFECT_TYPE_NONE	$EFFECT_TYPE_NONE	$EFFECT_TYPE_NONE	A Built-in Variable: EFFECT_TYPE_NONE
EFFECT_TYPE_PHASER	$EFFECT_TYPE_PHASER	$EFFECT_TYPE_PHASER	A Built-in Variable: EFFECT_TYPE_PHASER
EFFECT_TYPE_REVERB	$EFFECT_TYPE_REVERB	$EFFECT_TYPE_REVERB	A Built-in Variable: EFFECT_TYPE_REVERB
EFFECT_TYPE_ROTATOR	$EFFECT_TYPE_ROTATOR	$EFFECT_TYPE_ROTATOR	A Built-in Variable: EFFECT_TYPE_ROTATOR
EFFECT_TYPE_SEND_LEVELS	$EFFECT_TYPE_SEND_LEVELS	$EFFECT_TYPE_SEND_LEVELS	A Built-in Variable: EFFECT_TYPE_SEND_LEVELS
EFFECT_TYPE_SHAPER	$EFFECT_TYPE_SHAPER	$EFFECT_TYPE_SHAPER	A Built-in Variable: EFFECT_TYPE_SHAPER
EFFECT_TYPE_SKREAMER	$EFFECT_TYPE_SKREAMER	$EFFECT_TYPE_SKREAMER	A Built-in Variable: EFFECT_TYPE_SKREAMER
EFFECT_TYPE_SOLID_GEQ	$EFFECT_TYPE_SOLID_GEQ	$EFFECT_TYPE_SOLID_GEQ	A Built-in Variable: EFFECT_TYPE_SOLID_GEQ
EFFECT_TYPE_STEREO	$EFFECT_TYPE_STEREO	$EFFECT_TYPE_STEREO	A Built-in Variable: EFFECT_TYPE_STEREO
EFFECT_TYPE_SURROUND_PANNER	$EFFECT_TYPE_SURROUND_PANNER	$EFFECT_TYPE_SURROUND_PANNER	A Built-in Variable: EFFECT_TYPE_SURROUND_PANNER
EFFECT_TYPE_TAPE_SAT	$EFFECT_TYPE_TAPE_SAT	$EFFECT_TYPE_TAPE_SAT	A Built-in Variable: EFFECT_TYPE_TAPE_SAT
EFFECT_TYPE_TRANS_MASTER	$EFFECT_TYPE_TRANS_MASTER	$EFFECT_TYPE_TRANS_MASTER	A Built-in Variable: EFFECT_TYPE_TRANS_MASTER
EFFECT_TYPE_TWANG	$EFFECT_TYPE_TWANG	$EFFECT_TYPE_TWANG	A Built-in Variable: EFFECT_TYPE_TWANG
ENGINE_PAR_ATK_CURVE	$ENGINE_PAR_ATK_CURVE	$ENGINE_PAR_ATK_CURVE	A Built-in Variable: ENGINE_PAR_ATK_CURVE
ENGINE_PAR_ATTACK	$ENGINE_PAR_ATTACK	$ENGINE_PAR_ATTACK	A Built-in Variable: ENGINE_PAR_ATTACK
ENGINE_PAR_ATTACK_UNIT	$ENGINE_PAR_ATTACK_UNIT	$ENGINE_PAR_ATTACK_UNIT	A Built-in Variable: ENGINE_PAR_ATTACK_UNIT
ENGINE_PAR_BANDWIDTH	$ENGINE_PAR_BANDWIDTH	$ENGINE_PAR_BANDWIDTH	A Built-in Variable: ENGINE_PAR_BANDWIDTH
ENGINE_PAR_BITS	$ENGINE_PAR_BITS	$ENGINE_PAR_BITS	A Built-in Variable: ENGINE_PAR_BITS
ENGINE_PAR_BREAK	$ENGINE_PAR_BREAK	$ENGINE_PAR_BREAK	A Built-in Variable: ENGINE_PAR_BREAK
ENGINE_PAR_BW1	$ENGINE_PAR_BW1	$ENGINE_PAR_BW1	A Built-in Variable: ENGINE_PAR_BW1
ENGINE_PAR_BW2	$ENGINE_PAR_BW2	$ENGINE_PAR_BW2	A Built-in Variable: ENGINE_PAR_BW2
ENGINE_PAR_BW3	$ENGINE_PAR_BW3	$ENGINE_PAR_BW3	A Built-in Variable: ENGINE_PAR_BW3
ENGINE_PAR_CABINET_TYPE	$ENGINE_PAR_CABINET_TYPE	$ENGINE_PAR_CABINET_TYPE	A Built-in Variable: ENGINE_PAR_CABINET_TYPE
ENGINE_PAR_CB_AIR	$ENGINE_PAR_CB_AIR	$ENGINE_PAR_CB_AIR	A Built-in Variable: ENGINE_PAR_CB_AIR
ENGINE_PAR_CB_BASS	$ENGINE_PAR_CB_BASS	$ENGINE_PAR_CB_BASS	A Built-in Variable: ENGINE_PAR_CB_BASS
ENGINE_PAR_CB_SIZE	$ENGINE_PAR_CB_SIZE	$ENGINE_PAR_CB_SIZE	A Built-in Variable: ENGINE_PAR_CB_SIZE
ENGINE_PAR_CB_TREBLE	$ENGINE_PAR_CB_TREBLE	$ENGINE_PAR_CB_TREBLE	A Built-in Variable: ENGINE_PAR_CB_TREBLE
ENGINE_PAR_CH_DEPTH	$ENGINE_PAR_CH_DEPTH	$ENGINE_PAR_CH_DEPTH	A Built-in Variable: ENGINE_PAR_CH_DEPTH
ENGINE_PAR_CH_PHASE	$ENGINE_PAR_CH_PHASE	$ENGINE_PAR_CH_PHASE	A Built-in Variable: ENGINE_PAR_CH_PHASE
ENGINE_PAR_CH_SPEED	$ENGINE_PAR_CH_SPEED	$ENGINE_PAR_CH_SPEED	A Built-in Variable: ENGINE_PAR_CH_SPEED
ENGINE_PAR_CH_SPEED_UNIT	$ENGINE_PAR_CH_SPEED_UNIT	$ENGINE_PAR_CH_SPEED_UNIT	A Built-in Variable: ENGINE_PAR_CH_SPEED_UNIT
ENGINE_PAR_COMP_ATTACK	$ENGINE_PAR_COMP_ATTACK	$ENGINE_PAR_COMP_ATTACK	A Built-in Variable: ENGINE_PAR_COMP_ATTACK
ENGINE_PAR_COMP_DECAY	$ENGINE_PAR_COMP_DECAY	$ENGINE_PAR_COMP_DECAY	A Built-in Variable: ENGINE_PAR_COMP_DECAY
ENGINE_PAR_CUTOFF	$ENGINE_PAR_CUTOFF	$ENGINE_PAR_CUTOFF	A Built-in Variable: ENGINE_PAR_CUTOFF
ENGINE_PAR_DAMPING	$ENGINE_PAR_DAMPING	$ENGINE_PAR_DAMPING	A Built-in Variable: ENGINE_PAR_DAMPING
ENGINE_PAR_DECAY	$ENGINE_PAR_DECAY	$ENGINE_PAR_DECAY	A Built-in Variable: ENGINE_PAR_DECAY
ENGINE_PAR_DECAY1	$ENGINE_PAR_DECAY1	$ENGINE_PAR_DECAY1	A Built-in Variable: ENGINE_PAR_DECAY1
ENGINE_PAR_DECAY1_UNIT	$ENGINE_PAR_DECAY1_UNIT	$ENGINE_PAR_DECAY1_UNIT	A Built-in Variable: ENGINE_PAR_DECAY1_UNIT
ENGINE_PAR_DECAY2	$ENGINE_PAR_DECAY2	$ENGINE_PAR_DECAY2	A Built-in Variable: ENGINE_PAR_DECAY2
ENGINE_PAR_DECAY2_UNIT	$ENGINE_PAR_DECAY2_UNIT	$ENGINE_PAR_DECAY2_UNIT	A Built-in Variable: ENGINE_PAR_DECAY2_UNIT
ENGINE_PAR_DECAY_UNIT	$ENGINE_PAR_DECAY_UNIT	$ENGINE_PAR_DECAY_UNIT	A Built-in Variable: ENGINE_PAR_DECAY_UNIT
ENGINE_PAR_DL_DAMPING	$ENGINE_PAR_DL_DAMPING	$ENGINE_PAR_DL_DAMPING	A Built-in Variable: ENGINE_PAR_DL_DAMPING
ENGINE_PAR_DL_FEEDBACK	$ENGINE_PAR_DL_FEEDBACK	$ENGINE_PAR_DL_FEEDBACK	A Built-in Variable: ENGINE_PAR_DL_FEEDBACK
ENGINE_PAR_DL_PAN	$ENGINE_PAR_DL_PAN	$ENGINE_PAR_DL_PAN	A Built-in Variable: ENGINE_PAR_DL_PAN
ENGINE_PAR_DL_TIME	$ENGINE_PAR_DL_TIME	$ENGINE_PAR_DL_TIME	A Built-in Variable: ENGINE_PAR_DL_TIME
ENGINE_PAR_DL_TIME_UNIT	$ENGINE_PAR_DL_TIME_UNIT	$ENGINE_PAR_DL_TIME_UNIT	A Built-in Variable: ENGINE_PAR_DL_TIME_UNIT
ENGINE_PAR_DRIVE	$ENGINE_PAR_DRIVE	$ENGINE_PAR_DRIVE	A Built-in Variable: ENGINE_PAR_DRIVE
ENGINE_PAR_EFFECT_BYPASS	$ENGINE_PAR_EFFECT_BYPASS	$ENGINE_PAR_EFFECT_BYPASS	A Built-in Variable: ENGINE_PAR_EFFECT_BYPASS
ENGINE_PAR_EFFECT_SUBTYPE	$ENGINE_PAR_EFFECT_SUBTYPE	$ENGINE_PAR_EFFECT_SUBTYPE	A Built-in Variable: ENGINE_PAR_EFFECT_SUBTYPE
ENGINE_PAR_EFFECT_TYPE	$ENGINE_PAR_EFFECT_TYPE	$ENGINE_PAR_EFFECT_TYPE	A Built-in Variable: ENGINE_PAR_EFFECT_TYPE
ENGINE_PAR_ENVELOPE_ORDER	$ENGINE_PAR_ENVELOPE_ORDER	$ENGINE_PAR_ENVELOPE_ORDER	A Built-in Variable: ENGINE_PAR_ENVELOPE_ORDER
ENGINE_PAR_EXP_FILTER_AMOUNT	$ENGINE_PAR_EXP_FILTER_AMOUNT	$ENGINE_PAR_EXP_FILTER_AMOUNT	A Built-in Variable: ENGINE_PAR_EXP_FILTER_AMOUNT
ENGINE_PAR_EXP_FILTER_MORPH	$ENGINE_PAR_EXP_FILTER_MORPH	$ENGINE_PAR_EXP_FILTER_MORPH	A Built-in Variable: ENGINE_PAR_EXP_FILTER_MORPH
ENGINE_PAR_FCOMP_ATTACK	$ENGINE_PAR_FCOMP_ATTACK	$ENGINE_PAR_FCOMP_ATTACK	A Built-in Variable: ENGINE_PAR_FCOMP_ATTACK
ENGINE_PAR_FCOMP_INPUT	$ENGINE_PAR_FCOMP_INPUT	$ENGINE_PAR_FCOMP_INPUT	A Built-in Variable: ENGINE_PAR_FCOMP_INPUT
ENGINE_PAR_FCOMP_MAKEUP	$ENGINE_PAR_FCOMP_MAKEUP	$ENGINE_PAR_FCOMP_MAKEUP	A Built-in Variable: ENGINE_PAR_FCOMP_MAKEUP
ENGINE_PAR_FCOMP_MIX	$ENGINE_PAR_FCOMP_MIX	$ENGINE_PAR_FCOMP_MIX	A Built-in Variable: ENGINE_PAR_FCOMP_MIX
ENGINE_PAR_FCOMP_RATIO	$ENGINE_PAR_FCOMP_RATIO	$ENGINE_PAR_FCOMP_RATIO	A Built-in Variable: ENGINE_PAR_FCOMP_RATIO
ENGINE_PAR_FCOMP_RELEASE	$ENGINE_PAR_FCOMP_RELEASE	$ENGINE_PAR_FCOMP_RELEASE	A Built-in Variable: ENGINE_PAR_FCOMP_RELEASE
ENGINE_PAR_FILTER_BYPA	$ENGINE_PAR_FILTER_BYPA	$ENGINE_PAR_FILTER_BYPA	A Built-in Variable: ENGINE_PAR_FILTER_BYPA
ENGINE_PAR_FILTER_BYPB	$ENGINE_PAR_FILTER_BYPB	$ENGINE_PAR_FILTER_BYPB	A Built-in Variable: ENGINE_PAR_FILTER_BYPB
ENGINE_PAR_FILTER_BYPC	$ENGINE_PAR_FILTER_BYPC	$ENGINE_PAR_FILTER_BYPC	A Built-in Variable: ENGINE_PAR_FILTER_BYPC
ENGINE_PAR_FILTER_GAIN	$ENGINE_PAR_FILTER_GAIN	$ENGINE_PAR_FILTER_GAIN	A Built-in Variable: ENGINE_PAR_FILTER_GAIN
ENGINE_PAR_FILTER_RESB	$ENGINE_PAR_FILTER_RESB	$ENGINE_PAR_FILTER_RESB	A Built-in Variable: ENGINE_PAR_FILTER_RESB
ENGINE_PAR_FILTER_RESC	$ENGINE_PAR_FILTER_RESC	$ENGINE_PAR_FILTER_RESC	A Built-in Variable: ENGINE_PAR_FILTER_RESC
ENGINE_PAR_FILTER_SHIFTB	$ENGINE_PAR_FILTER_SHIFTB	$ENGINE_PAR_FILTER_SHIFTB	A Built-in Variable: ENGINE_PAR_FILTER_SHIFTB
ENGINE_PAR_FILTER_SHIFTC	$ENGINE_PAR_FILTER_SHIFTC	$ENGINE_PAR_FILTER_SHIFTC	A Built-in Variable: ENGINE_PAR_FILTER_SHIFTC
ENGINE_PAR_FILTER_TYPEA	$ENGINE_PAR_FILTER_TYPEA	$ENGINE_PAR_FILTER_TYPEA	A Built-in Variable: ENGINE_PAR_FILTER_TYPEA
ENGINE_PAR_FILTER_TYPEB	$ENGINE_PAR_FILTER_TYPEB	$ENGINE_PAR_FILTER_TYPEB	A Built-in Variable: ENGINE_PAR_FILTER_TYPEB
ENGINE_PAR_FILTER_TYPEC	$ENGINE_PAR_FILTER_TYPEC	$ENGINE_PAR_FILTER_TYPEC	A Built-in Variable: ENGINE_PAR_FILTER_TYPEC
ENGINE_PAR_FL_COLOR	$ENGINE_PAR_FL_COLOR	$ENGINE_PAR_FL_COLOR	A Built-in Variable: ENGINE_PAR_FL_COLOR
ENGINE_PAR_FL_DEPTH	$ENGINE_PAR_FL_DEPTH	$ENGINE_PAR_FL_DEPTH	A Built-in Variable: ENGINE_PAR_FL_DEPTH
ENGINE_PAR_FL_FEEDBACK	$ENGINE_PAR_FL_FEEDBACK	$ENGINE_PAR_FL_FEEDBACK	A Built-in Variable: ENGINE_PAR_FL_FEEDBACK
ENGINE_PAR_FL_PHASE	$ENGINE_PAR_FL_PHASE	$ENGINE_PAR_FL_PHASE	A Built-in Variable: ENGINE_PAR_FL_PHASE
ENGINE_PAR_FL_SPEED	$ENGINE_PAR_FL_SPEED	$ENGINE_PAR_FL_SPEED	A Built-in Variable: ENGINE_PAR_FL_SPEED
ENGINE_PAR_FL_SPEED_UNIT	$ENGINE_PAR_FL_SPEED_UNIT	$ENGINE_PAR_FL_SPEED_UNIT	A Built-in Variable: ENGINE_PAR_FL_SPEED_UNIT
ENGINE_PAR_FORMANT	$ENGINE_PAR_FORMANT	$ENGINE_PAR_FORMANT	A Built-in Variable: ENGINE_PAR_FORMANT
ENGINE_PAR_FORMANT_SHARP	$ENGINE_PAR_FORMANT_SHARP	$ENGINE_PAR_FORMANT_SHARP	A Built-in Variable: ENGINE_PAR_FORMANT_SHARP
ENGINE_PAR_FORMANT_SHIFT	$ENGINE_PAR_FORMANT_SHIFT	$ENGINE_PAR_FORMANT_SHIFT	A Built-in Variable: ENGINE_PAR_FORMANT_SHIFT
ENGINE_PAR_FORMANT_SIZE	$ENGINE_PAR_FORMANT_SIZE	$ENGINE_PAR_FORMANT_SIZE	A Built-in Variable: ENGINE_PAR_FORMANT_SIZE
ENGINE_PAR_FORMANT_TALK	$ENGINE_PAR_FORMANT_TALK	$ENGINE_PAR_FORMANT_TALK	A Built-in Variable: ENGINE_PAR_FORMANT_TALK
ENGINE_PAR_FREQ1	$ENGINE_PAR_FREQ1	$ENGINE_PAR_FREQ1	A Built-in Variable: ENGINE_PAR_FREQ1
ENGINE_PAR_FREQ2	$ENGINE_PAR_FREQ2	$ENGINE_PAR_FREQ2	A Built-in Variable: ENGINE_PAR_FREQ2
ENGINE_PAR_FREQ3	$ENGINE_PAR_FREQ3	$ENGINE_PAR_FREQ3	A Built-in Variable: ENGINE_PAR_FREQ3
ENGINE_PAR_FREQUENCY	$ENGINE_PAR_FREQUENCY	$ENGINE_PAR_FREQUENCY	A Built-in Variable: ENGINE_PAR_FREQUENCY
ENGINE_PAR_GAIN	$ENGINE_PAR_GAIN	$ENGINE_PAR_GAIN	A Built-in Variable: ENGINE_PAR_GAIN
ENGINE_PAR_GAIN1	$ENGINE_PAR_GAIN1	$ENGINE_PAR_GAIN1	A Built-in Variable: ENGINE_PAR_GAIN1
ENGINE_PAR_GAIN2	$ENGINE_PAR_GAIN2	$ENGINE_PAR_GAIN2	A Built-in Variable: ENGINE_PAR_GAIN2
ENGINE_PAR_GAIN3	$ENGINE_PAR_GAIN3	$ENGINE_PAR_GAIN3	A Built-in Variable: ENGINE_PAR_GAIN3
ENGINE_PAR_GLIDE_COEF	$ENGINE_PAR_GLIDE_COEF	$ENGINE_PAR_GLIDE_COEF	A Built-in Variable: ENGINE_PAR_GLIDE_COEF
ENGINE_PAR_GLIDE_COEF_UNIT	$ENGINE_PAR_GLIDE_COEF_UNIT	$ENGINE_PAR_GLIDE_COEF_UNIT	A Built-in Variable: ENGINE_PAR_GLIDE_COEF_UNIT
ENGINE_PAR_GN_GAIN	$ENGINE_PAR_GN_GAIN	$ENGINE_PAR_GN_GAIN	A Built-in Variable: ENGINE_PAR_GN_GAIN
ENGINE_PAR_GRAIN_LENGTH	$ENGINE_PAR_GRAIN_LENGTH	$ENGINE_PAR_GRAIN_LENGTH	A Built-in Variable: ENGINE_PAR_GRAIN_LENGTH
ENGINE_PAR_HOLD	$ENGINE_PAR_HOLD	$ENGINE_PAR_HOLD	A Built-in Variable: ENGINE_PAR_HOLD
ENGINE_PAR_HOLD_UNIT	$ENGINE_PAR_HOLD_UNIT	$ENGINE_PAR_HOLD_UNIT	A Built-in Variable: ENGINE_PAR_HOLD_UNIT
ENGINE_PAR_HP_CUTOFF	$ENGINE_PAR_HP_CUTOFF	$ENGINE_PAR_HP_CUTOFF	A Built-in Variable: ENGINE_PAR_HP_CUTOFF
ENGINE_PAR_INSERT_EFFECT_OUTPUT_GAIN	$ENGINE_PAR_INSERT_EFFECT_OUTPUT_GAIN	$ENGINE_PAR_INSERT_EFFECT_OUTPUT_GAIN	A Built-in Variable: ENGINE_PAR_INSERT_EFFECT_OUTPUT_GAIN
ENGINE_PAR_INTMOD_BYPASS	$ENGINE_PAR_INTMOD_BYPASS	$ENGINE_PAR_INTMOD_BYPASS	A Built-in Variable: ENGINE_PAR_INTMOD_BYPASS
ENGINE_PAR_INTMOD_FREQUENCY	$ENGINE_PAR_INTMOD_FREQUENCY	$ENGINE_PAR_INTMOD_FREQUENCY	A Built-in Variable: ENGINE_PAR_INTMOD_FREQUENCY
ENGINE_PAR_INTMOD_FREQUENCY_UNIT	$ENGINE_PAR_INTMOD_FREQUENCY_UNIT	$ENGINE_PAR_INTMOD_FREQUENCY_UNIT	A Built-in Variable: ENGINE_PAR_INTMOD_FREQUENCY_UNIT
ENGINE_PAR_INTMOD_PULSEWIDTH	$ENGINE_PAR_INTMOD_PULSEWIDTH	$ENGINE_PAR_INTMOD_PULSEWIDTH	A Built-in Variable: ENGINE_PAR_INTMOD_PULSEWIDTH
ENGINE_PAR_INTMOD_SUBTYPE	$ENGINE_PAR_INTMOD_SUBTYPE	$ENGINE_PAR_INTMOD_SUBTYPE	A Built-in Variable: ENGINE_PAR_INTMOD_SUBTYPE
ENGINE_PAR_INTMOD_TYPE	$ENGINE_PAR_INTMOD_TYPE	$ENGINE_PAR_INTMOD_TYPE	A Built-in Variable: ENGINE_PAR_INTMOD_TYPE
ENGINE_PAR_IRC_FREQ_HIGHPASS_ER	$ENGINE_PAR_IRC_FREQ_HIGHPASS_ER	$ENGINE_PAR_IRC_FREQ_HIGHPASS_ER	A Built-in Variable: ENGINE_PAR_IRC_FREQ_HIGHPASS_ER
ENGINE_PAR_IRC_FREQ_HIGHPASS_LR	$ENGINE_PAR_IRC_FREQ_HIGHPASS_LR	$ENGINE_PAR_IRC_FREQ_HIGHPASS_LR	A Built-in Variable: ENGINE_PAR_IRC_FREQ_HIGHPASS_LR
ENGINE_PAR_IRC_FREQ_LOWPASS_ER	$ENGINE_PAR_IRC_FREQ_LOWPASS_ER	$ENGINE_PAR_IRC_FREQ_LOWPASS_ER	A Built-in Variable: ENGINE_PAR_IRC_FREQ_LOWPASS_ER
ENGINE_PAR_IRC_FREQ_LOWPASS_LR	$ENGINE_PAR_IRC_FREQ_LOWPASS_LR	$ENGINE_PAR_IRC_FREQ_LOWPASS_LR	A Built-in Variable: ENGINE_PAR_IRC_FREQ_LOWPASS_LR
ENGINE_PAR_IRC_LENGTH_RATIO_ER	$ENGINE_PAR_IRC_LENGTH_RATIO_ER	$ENGINE_PAR_IRC_LENGTH_RATIO_ER	A Built-in Variable: ENGINE_PAR_IRC_LENGTH_RATIO_ER
ENGINE_PAR_IRC_LENGTH_RATIO_LR	$ENGINE_PAR_IRC_LENGTH_RATIO_LR	$ENGINE_PAR_IRC_LENGTH_RATIO_LR	A Built-in Variable: ENGINE_PAR_IRC_LENGTH_RATIO_LR
ENGINE_PAR_IRC_PREDELAY	$ENGINE_PAR_IRC_PREDELAY	$ENGINE_PAR_IRC_PREDELAY	A Built-in Variable: ENGINE_PAR_IRC_PREDELAY
ENGINE_PAR_JMP_BASS	$ENGINE_PAR_JMP_BASS	$ENGINE_PAR_JMP_BASS	A Built-in Variable: ENGINE_PAR_JMP_BASS
ENGINE_PAR_JMP_HIGAIN	$ENGINE_PAR_JMP_HIGAIN	$ENGINE_PAR_JMP_HIGAIN	A Built-in Variable: ENGINE_PAR_JMP_HIGAIN
ENGINE_PAR_JMP_MASTER	$ENGINE_PAR_JMP_MASTER	$ENGINE_PAR_JMP_MASTER	A Built-in Variable: ENGINE_PAR_JMP_MASTER
ENGINE_PAR_JMP_MID	$ENGINE_PAR_JMP_MID	$ENGINE_PAR_JMP_MID	A Built-in Variable: ENGINE_PAR_JMP_MID
ENGINE_PAR_JMP_MONO	$ENGINE_PAR_JMP_MONO	$ENGINE_PAR_JMP_MONO	A Built-in Variable: ENGINE_PAR_JMP_MONO
ENGINE_PAR_JMP_PREAMP	$ENGINE_PAR_JMP_PREAMP	$ENGINE_PAR_JMP_PREAMP	A Built-in Variable: ENGINE_PAR_JMP_PREAMP
ENGINE_PAR_JMP_PRESENCE	$ENGINE_PAR_JMP_PRESENCE	$ENGINE_PAR_JMP_PRESENCE	A Built-in Variable: ENGINE_PAR_JMP_PRESENCE
ENGINE_PAR_JMP_TREBLE	$ENGINE_PAR_JMP_TREBLE	$ENGINE_PAR_JMP_TREBLE	A Built-in Variable: ENGINE_PAR_JMP_TREBLE
ENGINE_PAR_LFO_DELAY	$ENGINE_PAR_LFO_DELAY	$ENGINE_PAR_LFO_DELAY	A Built-in Variable: ENGINE_PAR_LFO_DELAY
ENGINE_PAR_LFO_DELAY_UNIT	$ENGINE_PAR_LFO_DELAY_UNIT	$ENGINE_PAR_LFO_DELAY_UNIT	A Built-in Variable: ENGINE_PAR_LFO_DELAY_UNIT
ENGINE_PAR_LFO_RAND	$ENGINE_PAR_LFO_RAND	$ENGINE_PAR_LFO_RAND	A Built-in Variable: ENGINE_PAR_LFO_RAND
ENGINE_PAR_LFO_RECT	$ENGINE_PAR_LFO_RECT	$ENGINE_PAR_LFO_RECT	A Built-in Variable: ENGINE_PAR_LFO_RECT
ENGINE_PAR_LFO_SAW	$ENGINE_PAR_LFO_SAW	$ENGINE_PAR_LFO_SAW	A Built-in Variable: ENGINE_PAR_LFO_SAW
ENGINE_PAR_LFO_SINE	$ENGINE_PAR_LFO_SINE	$ENGINE_PAR_LFO_SINE	A Built-in Variable: ENGINE_PAR_LFO_SINE
ENGINE_PAR_LFO_TRI	$ENGINE_PAR_LFO_TRI	$ENGINE_PAR_LFO_TRI	A Built-in Variable: ENGINE_PAR_LFO_TRI
ENGINE_PAR_LIM_IN_GAIN	$ENGINE_PAR_LIM_IN_GAIN	$ENGINE_PAR_LIM_IN_GAIN	A Built-in Variable: ENGINE_PAR_LIM_IN_GAIN
ENGINE_PAR_LIM_RELEASE	$ENGINE_PAR_LIM_RELEASE	$ENGINE_PAR_LIM_RELEASE	A Built-in Variable: ENGINE_PAR_LIM_RELEASE
ENGINE_PAR_LP_CUTOFF	$ENGINE_PAR_LP_CUTOFF	$ENGINE_PAR_LP_CUTOFF	A Built-in Variable: ENGINE_PAR_LP_CUTOFF
ENGINE_PAR_MOD_TARGET_INTENSITY	$ENGINE_PAR_MOD_TARGET_INTENSITY	$ENGINE_PAR_MOD_TARGET_INTENSITY	A Built-in Variable: ENGINE_PAR_MOD_TARGET_INTENSITY
ENGINE_PAR_NOISECOLOR	$ENGINE_PAR_NOISECOLOR	$ENGINE_PAR_NOISECOLOR	A Built-in Variable: ENGINE_PAR_NOISECOLOR
ENGINE_PAR_NOISELEVEL	$ENGINE_PAR_NOISELEVEL	$ENGINE_PAR_NOISELEVEL	A Built-in Variable: ENGINE_PAR_NOISELEVEL
ENGINE_PAR_OUTPUT_CHANNEL	$ENGINE_PAR_OUTPUT_CHANNEL	$ENGINE_PAR_OUTPUT_CHANNEL	A Built-in Variable: ENGINE_PAR_OUTPUT_CHANNEL
ENGINE_PAR_PAN	$ENGINE_PAR_PAN	$ENGINE_PAR_PAN	A Built-in Variable: ENGINE_PAR_PAN
ENGINE_PAR_PH_DEPTH	$ENGINE_PAR_PH_DEPTH	$ENGINE_PAR_PH_DEPTH	A Built-in Variable: ENGINE_PAR_PH_DEPTH
ENGINE_PAR_PH_FEEDBACK	$ENGINE_PAR_PH_FEEDBACK	$ENGINE_PAR_PH_FEEDBACK	A Built-in Variable: ENGINE_PAR_PH_FEEDBACK
ENGINE_PAR_PH_PHASE	$ENGINE_PAR_PH_PHASE	$ENGINE_PAR_PH_PHASE	A Built-in Variable: ENGINE_PAR_PH_PHASE
ENGINE_PAR_PH_SPEED	$ENGINE_PAR_PH_SPEED	$ENGINE_PAR_PH_SPEED	A Built-in Variable: ENGINE_PAR_PH_SPEED
ENGINE_PAR_PH_SPEED_UNIT	$ENGINE_PAR_PH_SPEED_UNIT	$ENGINE_PAR_PH_SPEED_UNIT	A Built-in Variable: ENGINE_PAR_PH_SPEED_UNIT
ENGINE_PAR_RATIO	$ENGINE_PAR_RATIO	$ENGINE_PAR_RATIO	A Built-in Variable: ENGINE_PAR_RATIO
ENGINE_PAR_RELEASE	$ENGINE_PAR_RELEASE	$ENGINE_PAR_RELEASE	A Built-in Variable: ENGINE_PAR_RELEASE
ENGINE_PAR_RELEASE_UNIT	$ENGINE_PAR_RELEASE_UNIT	$ENGINE_PAR_RELEASE_UNIT	A Built-in Variable: ENGINE_PAR_RELEASE_UNIT
ENGINE_PAR_RESONANCE	$ENGINE_PAR_RESONANCE	$ENGINE_PAR_RESONANCE	A Built-in Variable: ENGINE_PAR_RESONANCE
ENGINE_PAR_RT_ACCEL_HI	$ENGINE_PAR_RT_ACCEL_HI	$ENGINE_PAR_RT_ACCEL_HI	A Built-in Variable: ENGINE_PAR_RT_ACCEL_HI
ENGINE_PAR_RT_ACCEL_LO	$ENGINE_PAR_RT_ACCEL_LO	$ENGINE_PAR_RT_ACCEL_LO	A Built-in Variable: ENGINE_PAR_RT_ACCEL_LO
ENGINE_PAR_RT_BALANCE	$ENGINE_PAR_RT_BALANCE	$ENGINE_PAR_RT_BALANCE	A Built-in Variable: ENGINE_PAR_RT_BALANCE
ENGINE_PAR_RT_DISTANCE	$ENGINE_PAR_RT_DISTANCE	$ENGINE_PAR_RT_DISTANCE	A Built-in Variable: ENGINE_PAR_RT_DISTANCE
ENGINE_PAR_RT_MIX	$ENGINE_PAR_RT_MIX	$ENGINE_PAR_RT_MIX	A Built-in Variable: ENGINE_PAR_RT_MIX
ENGINE_PAR_RT_SPEED	$ENGINE_PAR_RT_SPEED	$ENGINE_PAR_RT_SPEED	A Built-in Variable: ENGINE_PAR_RT_SPEED
ENGINE_PAR_RV_COLOUR	$ENGINE_PAR_RV_COLOUR	$ENGINE_PAR_RV_COLOUR	A Built-in Variable: ENGINE_PAR_RV_COLOUR
ENGINE_PAR_RV_DAMPING	$ENGINE_PAR_RV_DAMPING	$ENGINE_PAR_RV_DAMPING	A Built-in Variable: ENGINE_PAR_RV_DAMPING
ENGINE_PAR_RV_PREDELAY	$ENGINE_PAR_RV_PREDELAY	$ENGINE_PAR_RV_PREDELAY	A Built-in Variable: ENGINE_PAR_RV_PREDELAY
ENGINE_PAR_RV_SIZE	$ENGINE_PAR_RV_SIZE	$ENGINE_PAR_RV_SIZE	A Built-in Variable: ENGINE_PAR_RV_SIZE
ENGINE_PAR_RV_STEREO	$ENGINE_PAR_RV_STEREO	$ENGINE_PAR_RV_STEREO	A Built-in Variable: ENGINE_PAR_RV_STEREO
ENGINE_PAR_SCOMP_ATTACK	$ENGINE_PAR_SCOMP_ATTACK	$ENGINE_PAR_SCOMP_ATTACK	A Built-in Variable: ENGINE_PAR_SCOMP_ATTACK
ENGINE_PAR_SCOMP_MAKEUP	$ENGINE_PAR_SCOMP_MAKEUP	$ENGINE_PAR_SCOMP_MAKEUP	A Built-in Variable: ENGINE_PAR_SCOMP_MAKEUP
ENGINE_PAR_SCOMP_MIX	$ENGINE_PAR_SCOMP_MIX	$ENGINE_PAR_SCOMP_MIX	A Built-in Variable: ENGINE_PAR_SCOMP_MIX
ENGINE_PAR_SCOMP_RATIO	$ENGINE_PAR_SCOMP_RATIO	$ENGINE_PAR_SCOMP_RATIO	A Built-in Variable: ENGINE_PAR_SCOMP_RATIO
ENGINE_PAR_SCOMP_RELEASE	$ENGINE_PAR_SCOMP_RELEASE	$ENGINE_PAR_SCOMP_RELEASE	A Built-in Variable: ENGINE_PAR_SCOMP_RELEASE
ENGINE_PAR_SCOMP_THRESHOLD	$ENGINE_PAR_SCOMP_THRESHOLD	$ENGINE_PAR_SCOMP_THRESHOLD	A Built-in Variable: ENGINE_PAR_SCOMP_THRESHOLD
ENGINE_PAR_SENDLEVEL_0	$ENGINE_PAR_SENDLEVEL_0	$ENGINE_PAR_SENDLEVEL_0	A Built-in Variable: ENGINE_PAR_SENDLEVEL_0
ENGINE_PAR_SENDLEVEL_1	$ENGINE_PAR_SENDLEVEL_1	$ENGINE_PAR_SENDLEVEL_1	A Built-in Variable: ENGINE_PAR_SENDLEVEL_1
ENGINE_PAR_SENDLEVEL_2	$ENGINE_PAR_SENDLEVEL_2	$ENGINE_PAR_SENDLEVEL_2	A Built-in Variable: ENGINE_PAR_SENDLEVEL_2
ENGINE_PAR_SENDLEVEL_7	$ENGINE_PAR_SENDLEVEL_7	$ENGINE_PAR_SENDLEVEL_7	A Built-in Variable: ENGINE_PAR_SENDLEVEL_7
ENGINE_PAR_SEND_EFFECT_BYPASS	$ENGINE_PAR_SEND_EFFECT_BYPASS	$ENGINE_PAR_SEND_EFFECT_BYPASS	A Built-in Variable: ENGINE_PAR_SEND_EFFECT_BYPASS
ENGINE_PAR_SEND_EFFECT_DRY_LEVEL	$ENGINE_PAR_SEND_EFFECT_DRY_LEVEL	$ENGINE_PAR_SEND_EFFECT_DRY_LEVEL	A Built-in Variable: ENGINE_PAR_SEND_EFFECT_DRY_LEVEL
ENGINE_PAR_SEND_EFFECT_OUTPUT_GAIN	$ENGINE_PAR_SEND_EFFECT_OUTPUT_GAIN	$ENGINE_PAR_SEND_EFFECT_OUTPUT_GAIN	A Built-in Variable: ENGINE_PAR_SEND_EFFECT_OUTPUT_GAIN
ENGINE_PAR_SEND_EFFECT_TYPE	$ENGINE_PAR_SEND_EFFECT_TYPE	$ENGINE_PAR_SEND_EFFECT_TYPE	A Built-in Variable: ENGINE_PAR_SEND_EFFECT_TYPE
ENGINE_PAR_SEQ_HF_BELL	$ENGINE_PAR_SEQ_HF_BELL	$ENGINE_PAR_SEQ_HF_BELL	A Built-in Variable: ENGINE_PAR_SEQ_HF_BELL
ENGINE_PAR_SEQ_HF_FREQ	$ENGINE_PAR_SEQ_HF_FREQ	$ENGINE_PAR_SEQ_HF_FREQ	A Built-in Variable: ENGINE_PAR_SEQ_HF_FREQ
ENGINE_PAR_SEQ_HF_GAIN	$ENGINE_PAR_SEQ_HF_GAIN	$ENGINE_PAR_SEQ_HF_GAIN	A Built-in Variable: ENGINE_PAR_SEQ_HF_GAIN
ENGINE_PAR_SEQ_HMF_FREQ	$ENGINE_PAR_SEQ_HMF_FREQ	$ENGINE_PAR_SEQ_HMF_FREQ	A Built-in Variable: ENGINE_PAR_SEQ_HMF_FREQ
ENGINE_PAR_SEQ_HMF_GAIN	$ENGINE_PAR_SEQ_HMF_GAIN	$ENGINE_PAR_SEQ_HMF_GAIN	A Built-in Variable: ENGINE_PAR_SEQ_HMF_GAIN
ENGINE_PAR_SEQ_HMF_Q	$ENGINE_PAR_SEQ_HMF_Q	$ENGINE_PAR_SEQ_HMF_Q	A Built-in Variable: ENGINE_PAR_SEQ_HMF_Q
ENGINE_PAR_SEQ_LF_BELL	$ENGINE_PAR_SEQ_LF_BELL	$ENGINE_PAR_SEQ_LF_BELL	A Built-in Variable: ENGINE_PAR_SEQ_LF_BELL
ENGINE_PAR_SEQ_LF_FREQ	$ENGINE_PAR_SEQ_LF_FREQ	$ENGINE_PAR_SEQ_LF_FREQ	A Built-in Variable: ENGINE_PAR_SEQ_LF_FREQ
ENGINE_PAR_SEQ_LF_GAIN	$ENGINE_PAR_SEQ_LF_GAIN	$ENGINE_PAR_SEQ_LF_GAIN	A Built-in Variable: ENGINE_PAR_SEQ_LF_GAIN
ENGINE_PAR_SEQ_LMF_FREQ	$ENGINE_PAR_SEQ_LMF_FREQ	$ENGINE_PAR_SEQ_LMF_FREQ	A Built-in Variable: ENGINE_PAR_SEQ_LMF_FREQ
ENGINE_PAR_SEQ_LMF_GAIN	$ENGINE_PAR_SEQ_LMF_GAIN	$ENGINE_PAR_SEQ_LMF_GAIN	A Built-in Variable: ENGINE_PAR_SEQ_LMF_GAIN
ENGINE_PAR_SEQ_LMF_Q	$ENGINE_PAR_SEQ_LMF_Q	$ENGINE_PAR_SEQ_LMF_Q	A Built-in Variable: ENGINE_PAR_SEQ_LMF_Q
ENGINE_PAR_SHAPE	$ENGINE_PAR_SHAPE	$ENGINE_PAR_SHAPE	A Built-in Variable: ENGINE_PAR_SHAPE
ENGINE_PAR_SK_BASS	$ENGINE_PAR_SK_BASS	$ENGINE_PAR_SK_BASS	A Built-in Variable: ENGINE_PAR_SK_BASS
ENGINE_PAR_SK_BRIGHT	$ENGINE_PAR_SK_BRIGHT	$ENGINE_PAR_SK_BRIGHT	A Built-in Variable: ENGINE_PAR_SK_BRIGHT
ENGINE_PAR_SK_DRIVE	$ENGINE_PAR_SK_DRIVE	$ENGINE_PAR_SK_DRIVE	A Built-in Variable: ENGINE_PAR_SK_DRIVE
ENGINE_PAR_SK_MIX	$ENGINE_PAR_SK_MIX	$ENGINE_PAR_SK_MIX	A Built-in Variable: ENGINE_PAR_SK_MIX
ENGINE_PAR_SK_TONE	$ENGINE_PAR_SK_TONE	$ENGINE_PAR_SK_TONE	A Built-in Variable: ENGINE_PAR_SK_TONE
ENGINE_PAR_SLICE_ATTACK	$ENGINE_PAR_SLICE_ATTACK	$ENGINE_PAR_SLICE_ATTACK	A Built-in Variable: ENGINE_PAR_SLICE_ATTACK
ENGINE_PAR_SLICE_RELEASE	$ENGINE_PAR_SLICE_RELEASE	$ENGINE_PAR_SLICE_RELEASE	A Built-in Variable: ENGINE_PAR_SLICE_RELEASE
ENGINE_PAR_SMOOTH	$ENGINE_PAR_SMOOTH	$ENGINE_PAR_SMOOTH	A Built-in Variable: ENGINE_PAR_SMOOTH
ENGINE_PAR_SPEED	$ENGINE_PAR_SPEED	$ENGINE_PAR_SPEED	A Built-in Variable: ENGINE_PAR_SPEED
ENGINE_PAR_SPEED_UNIT	$ENGINE_PAR_SPEED_UNIT	$ENGINE_PAR_SPEED_UNIT	A Built-in Variable: ENGINE_PAR_SPEED_UNIT
ENGINE_PAR_SP_DIVERGENCE	$ENGINE_PAR_SP_DIVERGENCE	$ENGINE_PAR_SP_DIVERGENCE	A Built-in Variable: ENGINE_PAR_SP_DIVERGENCE
ENGINE_PAR_SP_LFE_VOLUME	$ENGINE_PAR_SP_LFE_VOLUME	$ENGINE_PAR_SP_LFE_VOLUME	A Built-in Variable: ENGINE_PAR_SP_LFE_VOLUME
ENGINE_PAR_SP_OFFSET_AZIMUTH	$ENGINE_PAR_SP_OFFSET_AZIMUTH	$ENGINE_PAR_SP_OFFSET_AZIMUTH	A Built-in Variable: ENGINE_PAR_SP_OFFSET_AZIMUTH
ENGINE_PAR_SP_OFFSET_DISTANCE	$ENGINE_PAR_SP_OFFSET_DISTANCE	$ENGINE_PAR_SP_OFFSET_DISTANCE	A Built-in Variable: ENGINE_PAR_SP_OFFSET_DISTANCE
ENGINE_PAR_SP_OFFSET_X	$ENGINE_PAR_SP_OFFSET_X	$ENGINE_PAR_SP_OFFSET_X	A Built-in Variable: ENGINE_PAR_SP_OFFSET_X
ENGINE_PAR_SP_OFFSET_Y	$ENGINE_PAR_SP_OFFSET_Y	$ENGINE_PAR_SP_OFFSET_Y	A Built-in Variable: ENGINE_PAR_SP_OFFSET_Y
ENGINE_PAR_SP_SIZE	$ENGINE_PAR_SP_SIZE	$ENGINE_PAR_SP_SIZE	A Built-in Variable: ENGINE_PAR_SP_SIZE
ENGINE_PAR_START_CRITERIA_CC_MAX	$ENGINE_PAR_START_CRITERIA_CC_MAX	$ENGINE_PAR_START_CRITERIA_CC_MAX	A Built-in Variable: ENGINE_PAR_START_CRITERIA_CC_MAX
ENGINE_PAR_START_CRITERIA_CC_MIN	$ENGINE_PAR_START_CRITERIA_CC_MIN	$ENGINE_PAR_START_CRITERIA_CC_MIN	A Built-in Variable: ENGINE_PAR_START_CRITERIA_CC_MIN
ENGINE_PAR_START_CRITERIA_CONTROLLER	$ENGINE_PAR_START_CRITERIA_CONTROLLER	$ENGINE_PAR_START_CRITERIA_CONTROLLER	A Built-in Variable: ENGINE_PAR_START_CRITERIA_CONTROLLER
ENGINE_PAR_START_CRITERIA_CYCLE_CLASS	$ENGINE_PAR_START_CRITERIA_CYCLE_CLASS	$ENGINE_PAR_START_CRITERIA_CYCLE_CLASS	A Built-in Variable: ENGINE_PAR_START_CRITERIA_CYCLE_CLASS
ENGINE_PAR_START_CRITERIA_KEY_MAX	$ENGINE_PAR_START_CRITERIA_KEY_MAX	$ENGINE_PAR_START_CRITERIA_KEY_MAX	A Built-in Variable: ENGINE_PAR_START_CRITERIA_KEY_MAX
ENGINE_PAR_START_CRITERIA_KEY_MIN	$ENGINE_PAR_START_CRITERIA_KEY_MIN	$ENGINE_PAR_START_CRITERIA_KEY_MIN	A Built-in Variable: ENGINE_PAR_START_CRITERIA_KEY_MIN
ENGINE_PAR_START_CRITERIA_MODE	$ENGINE_PAR_START_CRITERIA_MODE	$ENGINE_PAR_START_CRITERIA_MODE	A Built-in Variable: ENGINE_PAR_START_CRITERIA_MODE
ENGINE_PAR_START_CRITERIA_NEXT_CRIT	$ENGINE_PAR_START_CRITERIA_NEXT_CRIT	$ENGINE_PAR_START_CRITERIA_NEXT_CRIT	A Built-in Variable: ENGINE_PAR_START_CRITERIA_NEXT_CRIT
ENGINE_PAR_START_CRITERIA_SEQ_ONLY	$ENGINE_PAR_START_CRITERIA_SEQ_ONLY	$ENGINE_PAR_START_CRITERIA_SEQ_ONLY	A Built-in Variable: ENGINE_PAR_START_CRITERIA_SEQ_ONLY
ENGINE_PAR_START_CRITERIA_SLICE_IDX	$ENGINE_PAR_START_CRITERIA_SLICE_IDX	$ENGINE_PAR_START_CRITERIA_SLICE_IDX	A Built-in Variable: ENGINE_PAR_START_CRITERIA_SLICE_IDX
ENGINE_PAR_START_CRITERIA_ZONE_IDX	$ENGINE_PAR_START_CRITERIA_ZONE_IDX	$ENGINE_PAR_START_CRITERIA_ZONE_IDX	A Built-in Variable: ENGINE_PAR_START_CRITERIA_ZONE_IDX
ENGINE_PAR_STEREO	$ENGINE_PAR_STEREO	$ENGINE_PAR_STEREO	A Built-in Variable: ENGINE_PAR_STEREO
ENGINE_PAR_STEREO_PAN	$ENGINE_PAR_STEREO_PAN	$ENGINE_PAR_STEREO_PAN	A Built-in Variable: ENGINE_PAR_STEREO_PAN
ENGINE_PAR_SUSTAIN	$ENGINE_PAR_SUSTAIN	$ENGINE_PAR_SUSTAIN	A Built-in Variable: ENGINE_PAR_SUSTAIN
ENGINE_PAR_THRESHOLD	$ENGINE_PAR_THRESHOLD	$ENGINE_PAR_THRESHOLD	A Built-in Variable: ENGINE_PAR_THRESHOLD
ENGINE_PAR_TP_GAIN	$ENGINE_PAR_TP_GAIN	$ENGINE_PAR_TP_GAIN	A Built-in Variable: ENGINE_PAR_TP_GAIN
ENGINE_PAR_TP_HF_ROLLOFF	$ENGINE_PAR_TP_HF_ROLLOFF	$ENGINE_PAR_TP_HF_ROLLOFF	A Built-in Variable: ENGINE_PAR_TP_HF_ROLLOFF
ENGINE_PAR_TP_WARMTH	$ENGINE_PAR_TP_WARMTH	$ENGINE_PAR_TP_WARMTH	A Built-in Variable: ENGINE_PAR_TP_WARMTH
ENGINE_PAR_TRANSIENT_SIZE	$ENGINE_PAR_TRANSIENT_SIZE	$ENGINE_PAR_TRANSIENT_SIZE	A Built-in Variable: ENGINE_PAR_TRANSIENT_SIZE
ENGINE_PAR_TR_ATTACK	$ENGINE_PAR_TR_ATTACK	$ENGINE_PAR_TR_ATTACK	A Built-in Variable: ENGINE_PAR_TR_ATTACK
ENGINE_PAR_TR_INPUT	$ENGINE_PAR_TR_INPUT	$ENGINE_PAR_TR_INPUT	A Built-in Variable: ENGINE_PAR_TR_INPUT
ENGINE_PAR_TR_SUSTAIN	$ENGINE_PAR_TR_SUSTAIN	$ENGINE_PAR_TR_SUSTAIN	A Built-in Variable: ENGINE_PAR_TR_SUSTAIN
ENGINE_PAR_TUNE	$ENGINE_PAR_TUNE	$ENGINE_PAR_TUNE	A Built-in Variable: ENGINE_PAR_TUNE
ENGINE_PAR_TW_BASS	$ENGINE_PAR_TW_BASS	$ENGINE_PAR_TW_BASS	A Built-in Variable: ENGINE_PAR_TW_BASS
ENGINE_PAR_TW_MID	$ENGINE_PAR_TW_MID	$ENGINE_PAR_TW_MID	A Built-in Variable: ENGINE_PAR_TW_MID
ENGINE_PAR_TW_TREBLE	$ENGINE_PAR_TW_TREBLE	$ENGINE_PAR_TW_TREBLE	A Built-in Variable: ENGINE_PAR_TW_TREBLE
ENGINE_PAR_TW_VOLUME	$ENGINE_PAR_TW_VOLUME	$ENGINE_PAR_TW_VOLUME	A Built-in Variable: ENGINE_PAR_TW_VOLUME
ENGINE_PAR_VOLUME	$ENGINE_PAR_VOLUME	$ENGINE_PAR_VOLUME	A Built-in Variable: ENGINE_PAR_VOLUME
ENGINE_UPTIME	$ENGINE_UPTIME	$ENGINE_UPTIME	A Built-in Variable: ENGINE_UPTIME
ENV_TYPE_AHDSR	$ENV_TYPE_AHDSR	$ENV_TYPE_AHDSR	A Built-in Variable: ENV_TYPE_AHDSR
ENV_TYPE_DBD	$ENV_TYPE_DBD	$ENV_TYPE_DBD	A Built-in Variable: ENV_TYPE_DBD
ENV_TYPE_FLEX	$ENV_TYPE_FLEX	$ENV_TYPE_FLEX	A Built-in Variable: ENV_TYPE_FLEX
EVENT_ID	$EVENT_ID	$EVENT_ID	A Built-in Variable: EVENT_ID
EVENT_NOTE	$EVENT_NOTE	$EVENT_NOTE	A Built-in Variable: EVENT_NOTE
EVENT_PAR_0	$EVENT_PAR_0	$EVENT_PAR_0	A Built-in Variable: EVENT_PAR_0
EVENT_PAR_1	$EVENT_PAR_1	$EVENT_PAR_1	A Built-in Variable: EVENT_PAR_1
EVENT_PAR_2	$EVENT_PAR_2	$EVENT_PAR_2	A Built-in Variable: EVENT_PAR_2
EVENT_PAR_3	$EVENT_PAR_3	$EVENT_PAR_3	A Built-in Variable: EVENT_PAR_3
EVENT_PAR_ALLOW_GROUP	$EVENT_PAR_ALLOW_GROUP	$EVENT_PAR_ALLOW_GROUP	A Built-in Variable: EVENT_PAR_ALLOW_GROUP
EVENT_PAR_ID	$EVENT_PAR_ID	$EVENT_PAR_ID	A Built-in Variable: EVENT_PAR_ID
EVENT_PAR_MIDI_BYTE_1	$EVENT_PAR_MIDI_BYTE_1	$EVENT_PAR_MIDI_BYTE_1	A Built-in Variable: EVENT_PAR_MIDI_BYTE_1
EVENT_PAR_MIDI_BYTE_2	$EVENT_PAR_MIDI_BYTE_2	$EVENT_PAR_MIDI_BYTE_2	A Built-in Variable: EVENT_PAR_MIDI_BYTE_2
EVENT_PAR_MIDI_CHANNEL	$EVENT_PAR_MIDI_CHANNEL	$EVENT_PAR_MIDI_CHANNEL	A Built-in Variable: EVENT_PAR_MIDI_CHANNEL
EVENT_PAR_MIDI_COMMAND	$EVENT_PAR_MIDI_COMMAND	$EVENT_PAR_MIDI_COMMAND	A Built-in Variable: EVENT_PAR_MIDI_COMMAND
EVENT_PAR_NOTE	$EVENT_PAR_NOTE	$EVENT_PAR_NOTE	A Built-in Variable: EVENT_PAR_NOTE
EVENT_PAR_NOTE_LENGTH	$EVENT_PAR_NOTE_LENGTH	$EVENT_PAR_NOTE_LENGTH	A Built-in Variable: EVENT_PAR_NOTE_LENGTH
EVENT_PAR_PAN	$EVENT_PAR_PAN	$EVENT_PAR_PAN	A Built-in Variable: EVENT_PAR_PAN
EVENT_PAR_PLAY_POS	$EVENT_PAR_PLAY_POS	$EVENT_PAR_PLAY_POS	A Built-in Variable: EVENT_PAR_PLAY_POS
EVENT_PAR_POS	$EVENT_PAR_POS	$EVENT_PAR_POS	A Built-in Variable: EVENT_PAR_POS
EVENT_PAR_SOURCE	$EVENT_PAR_SOURCE	$EVENT_PAR_SOURCE	A Built-in Variable: EVENT_PAR_SOURCE
EVENT_PAR_TRACK_NR	$EVENT_PAR_TRACK_NR	$EVENT_PAR_TRACK_NR	A Built-in Variable: EVENT_PAR_TRACK_NR
EVENT_PAR_TUNE	$EVENT_PAR_TUNE	$EVENT_PAR_TUNE	A Built-in Variable: EVENT_PAR_TUNE
EVENT_PAR_VELOCITY	$EVENT_PAR_VELOCITY	$EVENT_PAR_VELOCITY	A Built-in Variable: EVENT_PAR_VELOCITY
EVENT_PAR_VOLUME	$EVENT_PAR_VOLUME	$EVENT_PAR_VOLUME	A Built-in Variable: EVENT_PAR_VOLUME
EVENT_PAR_ZONE_ID	$EVENT_PAR_ZONE_ID	$EVENT_PAR_ZONE_ID	A Built-in Variable: EVENT_PAR_ZONE_ID
EVENT_STATUS_INACTIVE	$EVENT_STATUS_INACTIVE	$EVENT_STATUS_INACTIVE	A Built-in Variable: EVENT_STATUS_INACTIVE
EVENT_STATUS_MIDI_QUEUE	$EVENT_STATUS_MIDI_QUEUE	$EVENT_STATUS_MIDI_QUEUE	A Built-in Variable: EVENT_STATUS_MIDI_QUEUE
EVENT_STATUS_NOTE_QUEUE	$EVENT_STATUS_NOTE_QUEUE	$EVENT_STATUS_NOTE_QUEUE	A Built-in Variable: EVENT_STATUS_NOTE_QUEUE
EVENT_VELOCITY	$EVENT_VELOCITY	$EVENT_VELOCITY	A Built-in Variable: EVENT_VELOCITY
FILTER_TYPE_AR_BP2	$FILTER_TYPE_AR_BP2	$FILTER_TYPE_AR_BP2	A Built-in Variable: FILTER_TYPE_AR_BP2
FILTER_TYPE_AR_BP24	$FILTER_TYPE_AR_BP24	$FILTER_TYPE_AR_BP24	A Built-in Variable: FILTER_TYPE_AR_BP24
FILTER_TYPE_AR_BP4	$FILTER_TYPE_AR_BP4	$FILTER_TYPE_AR_BP4	A Built-in Variable: FILTER_TYPE_AR_BP4
FILTER_TYPE_AR_HP2	$FILTER_TYPE_AR_HP2	$FILTER_TYPE_AR_HP2	A Built-in Variable: FILTER_TYPE_AR_HP2
FILTER_TYPE_AR_HP24	$FILTER_TYPE_AR_HP24	$FILTER_TYPE_AR_HP24	A Built-in Variable: FILTER_TYPE_AR_HP24
FILTER_TYPE_AR_HP4	$FILTER_TYPE_AR_HP4	$FILTER_TYPE_AR_HP4	A Built-in Variable: FILTER_TYPE_AR_HP4
FILTER_TYPE_AR_LP2	$FILTER_TYPE_AR_LP2	$FILTER_TYPE_AR_LP2	A Built-in Variable: FILTER_TYPE_AR_LP2
FILTER_TYPE_AR_LP24	$FILTER_TYPE_AR_LP24	$FILTER_TYPE_AR_LP24	A Built-in Variable: FILTER_TYPE_AR_LP24
FILTER_TYPE_AR_LP4	$FILTER_TYPE_AR_LP4	$FILTER_TYPE_AR_LP4	A Built-in Variable: FILTER_TYPE_AR_LP4
FILTER_TYPE_BP2POLE	$FILTER_TYPE_BP2POLE	$FILTER_TYPE_BP2POLE	A Built-in Variable: FILTER_TYPE_BP2POLE
FILTER_TYPE_BP4POLE	$FILTER_TYPE_BP4POLE	$FILTER_TYPE_BP4POLE	A Built-in Variable: FILTER_TYPE_BP4POLE
FILTER_TYPE_BR4POLE	$FILTER_TYPE_BR4POLE	$FILTER_TYPE_BR4POLE	A Built-in Variable: FILTER_TYPE_BR4POLE
FILTER_TYPE_DAFT_HP	$FILTER_TYPE_DAFT_HP	$FILTER_TYPE_DAFT_HP	A Built-in Variable: FILTER_TYPE_DAFT_HP
FILTER_TYPE_DAFT_LP	$FILTER_TYPE_DAFT_LP	$FILTER_TYPE_DAFT_LP	A Built-in Variable: FILTER_TYPE_DAFT_LP
FILTER_TYPE_EQ1BAND	$FILTER_TYPE_EQ1BAND	$FILTER_TYPE_EQ1BAND	A Built-in Variable: FILTER_TYPE_EQ1BAND
FILTER_TYPE_EQ2BAND	$FILTER_TYPE_EQ2BAND	$FILTER_TYPE_EQ2BAND	A Built-in Variable: FILTER_TYPE_EQ2BAND
FILTER_TYPE_EQ3BAND	$FILTER_TYPE_EQ3BAND	$FILTER_TYPE_EQ3BAND	A Built-in Variable: FILTER_TYPE_EQ3BAND
FILTER_TYPE_FORMANT_1	$FILTER_TYPE_FORMANT_1	$FILTER_TYPE_FORMANT_1	A Built-in Variable: FILTER_TYPE_FORMANT_1
FILTER_TYPE_FORMANT_2	$FILTER_TYPE_FORMANT_2	$FILTER_TYPE_FORMANT_2	A Built-in Variable: FILTER_TYPE_FORMANT_2
FILTER_TYPE_HP1POLE	$FILTER_TYPE_HP1POLE	$FILTER_TYPE_HP1POLE	A Built-in Variable: FILTER_TYPE_HP1POLE
FILTER_TYPE_HP2POLE	$FILTER_TYPE_HP2POLE	$FILTER_TYPE_HP2POLE	A Built-in Variable: FILTER_TYPE_HP2POLE
FILTER_TYPE_HP4POLE	$FILTER_TYPE_HP4POLE	$FILTER_TYPE_HP4POLE	A Built-in Variable: FILTER_TYPE_HP4POLE
FILTER_TYPE_LADDER	$FILTER_TYPE_LADDER	$FILTER_TYPE_LADDER	A Built-in Variable: FILTER_TYPE_LADDER
FILTER_TYPE_LDR_BP2	$FILTER_TYPE_LDR_BP2	$FILTER_TYPE_LDR_BP2	A Built-in Variable: FILTER_TYPE_LDR_BP2
FILTER_TYPE_LDR_BP4	$FILTER_TYPE_LDR_BP4	$FILTER_TYPE_LDR_BP4	A Built-in Variable: FILTER_TYPE_LDR_BP4
FILTER_TYPE_LDR_HP1	$FILTER_TYPE_LDR_HP1	$FILTER_TYPE_LDR_HP1	A Built-in Variable: FILTER_TYPE_LDR_HP1
FILTER_TYPE_LDR_HP2	$FILTER_TYPE_LDR_HP2	$FILTER_TYPE_LDR_HP2	A Built-in Variable: FILTER_TYPE_LDR_HP2
FILTER_TYPE_LDR_HP3	$FILTER_TYPE_LDR_HP3	$FILTER_TYPE_LDR_HP3	A Built-in Variable: FILTER_TYPE_LDR_HP3
FILTER_TYPE_LDR_HP4	$FILTER_TYPE_LDR_HP4	$FILTER_TYPE_LDR_HP4	A Built-in Variable: FILTER_TYPE_LDR_HP4
FILTER_TYPE_LDR_LP1	$FILTER_TYPE_LDR_LP1	$FILTER_TYPE_LDR_LP1	A Built-in Variable: FILTER_TYPE_LDR_LP1
FILTER_TYPE_LDR_LP2	$FILTER_TYPE_LDR_LP2	$FILTER_TYPE_LDR_LP2	A Built-in Variable: FILTER_TYPE_LDR_LP2
FILTER_TYPE_LDR_LP3	$FILTER_TYPE_LDR_LP3	$FILTER_TYPE_LDR_LP3	A Built-in Variable: FILTER_TYPE_LDR_LP3
FILTER_TYPE_LDR_LP4	$FILTER_TYPE_LDR_LP4	$FILTER_TYPE_LDR_LP4	A Built-in Variable: FILTER_TYPE_LDR_LP4
FILTER_TYPE_LDR_NOTCH	$FILTER_TYPE_LDR_NOTCH	$FILTER_TYPE_LDR_NOTCH	A Built-in Variable: FILTER_TYPE_LDR_NOTCH
FILTER_TYPE_LDR_PEAK	$FILTER_TYPE_LDR_PEAK	$FILTER_TYPE_LDR_PEAK	A Built-in Variable: FILTER_TYPE_LDR_PEAK
FILTER_TYPE_LP1POLE	$FILTER_TYPE_LP1POLE	$FILTER_TYPE_LP1POLE	A Built-in Variable: FILTER_TYPE_LP1POLE
FILTER_TYPE_LP2POLE	$FILTER_TYPE_LP2POLE	$FILTER_TYPE_LP2POLE	A Built-in Variable: FILTER_TYPE_LP2POLE
FILTER_TYPE_LP4POLE	$FILTER_TYPE_LP4POLE	$FILTER_TYPE_LP4POLE	A Built-in Variable: FILTER_TYPE_LP4POLE
FILTER_TYPE_LP6POLE	$FILTER_TYPE_LP6POLE	$FILTER_TYPE_LP6POLE	A Built-in Variable: FILTER_TYPE_LP6POLE
FILTER_TYPE_PHASER	$FILTER_TYPE_PHASER	$FILTER_TYPE_PHASER	A Built-in Variable: FILTER_TYPE_PHASER
FILTER_TYPE_PRO52	$FILTER_TYPE_PRO52	$FILTER_TYPE_PRO52	A Built-in Variable: FILTER_TYPE_PRO52
FILTER_TYPE_SIMPLE_LPHP	$FILTER_TYPE_SIMPLE_LPHP	$FILTER_TYPE_SIMPLE_LPHP	A Built-in Variable: FILTER_TYPE_SIMPLE_LPHP
FILTER_TYPE_SV_BP2	$FILTER_TYPE_SV_BP2	$FILTER_TYPE_SV_BP2	A Built-in Variable: FILTER_TYPE_SV_BP2
FILTER_TYPE_SV_BP4	$FILTER_TYPE_SV_BP4	$FILTER_TYPE_SV_BP4	A Built-in Variable: FILTER_TYPE_SV_BP4
FILTER_TYPE_SV_HP1	$FILTER_TYPE_SV_HP1	$FILTER_TYPE_SV_HP1	A Built-in Variable: FILTER_TYPE_SV_HP1
FILTER_TYPE_SV_HP2	$FILTER_TYPE_SV_HP2	$FILTER_TYPE_SV_HP2	A Built-in Variable: FILTER_TYPE_SV_HP2
FILTER_TYPE_SV_HP4	$FILTER_TYPE_SV_HP4	$FILTER_TYPE_SV_HP4	A Built-in Variable: FILTER_TYPE_SV_HP4
FILTER_TYPE_SV_LP1	$FILTER_TYPE_SV_LP1	$FILTER_TYPE_SV_LP1	A Built-in Variable: FILTER_TYPE_SV_LP1
FILTER_TYPE_SV_LP2	$FILTER_TYPE_SV_LP2	$FILTER_TYPE_SV_LP2	A Built-in Variable: FILTER_TYPE_SV_LP2
FILTER_TYPE_SV_LP4	$FILTER_TYPE_SV_LP4	$FILTER_TYPE_SV_LP4	A Built-in Variable: FILTER_TYPE_SV_LP4
FILTER_TYPE_SV_NOTCH4	$FILTER_TYPE_SV_NOTCH4	$FILTER_TYPE_SV_NOTCH4	A Built-in Variable: FILTER_TYPE_SV_NOTCH4
FILTER_TYPE_SV_PAR_BPBP	$FILTER_TYPE_SV_PAR_BPBP	$FILTER_TYPE_SV_PAR_BPBP	A Built-in Variable: FILTER_TYPE_SV_PAR_BPBP
FILTER_TYPE_SV_PAR_LPHP	$FILTER_TYPE_SV_PAR_LPHP	$FILTER_TYPE_SV_PAR_LPHP	A Built-in Variable: FILTER_TYPE_SV_PAR_LPHP
FILTER_TYPE_SV_SER_LPHP	$FILTER_TYPE_SV_SER_LPHP	$FILTER_TYPE_SV_SER_LPHP	A Built-in Variable: FILTER_TYPE_SV_SER_LPHP
FILTER_TYPE_VERSATILE	$FILTER_TYPE_VERSATILE	$FILTER_TYPE_VERSATILE	A Built-in Variable: FILTER_TYPE_VERSATILE
FILTER_TYPE_VOWELA	$FILTER_TYPE_VOWELA	$FILTER_TYPE_VOWELA	A Built-in Variable: FILTER_TYPE_VOWELA
FILTER_TYPE_VOWELB	$FILTER_TYPE_VOWELB	$FILTER_TYPE_VOWELB	A Built-in Variable: FILTER_TYPE_VOWELB
GET_FOLDER_FACTORY_DIR	$GET_FOLDER_FACTORY_DIR	$GET_FOLDER_FACTORY_DIR	A Built-in Variable: GET_FOLDER_FACTORY_DIR
GET_FOLDER_LIBRARY_DIR	$GET_FOLDER_LIBRARY_DIR	$GET_FOLDER_LIBRARY_DIR	A Built-in Variable: GET_FOLDER_LIBRARY_DIR
GET_FOLDER_PATCH_DIR	$GET_FOLDER_PATCH_DIR	$GET_FOLDER_PATCH_DIR	A Built-in Variable: GET_FOLDER_PATCH_DIR
HIDE_PART_BG	$HIDE_PART_BG	$HIDE_PART_BG	A Built-in Variable: HIDE_PART_BG
HIDE_PART_MOD_LIGHT	$HIDE_PART_MOD_LIGHT	$HIDE_PART_MOD_LIGHT	A Built-in Variable: HIDE_PART_MOD_LIGHT
HIDE_PART_NOTHING	$HIDE_PART_NOTHING	$HIDE_PART_NOTHING	A Built-in Variable: HIDE_PART_NOTHING
HIDE_PART_TITLE	$HIDE_PART_TITLE	$HIDE_PART_TITLE	A Built-in Variable: HIDE_PART_TITLE
HIDE_PART_VALUE	$HIDE_PART_VALUE	$HIDE_PART_VALUE	A Built-in Variable: HIDE_PART_VALUE
HIDE_WHOLE_CONTROL	$HIDE_WHOLE_CONTROL	$HIDE_WHOLE_CONTROL	A Built-in Variable: HIDE_WHOLE_CONTROL
INST_ICON_ID	$INST_ICON_ID	$INST_ICON_ID	A Built-in Variable: INST_ICON_ID
INST_WALLPAPER_ID	$INST_WALLPAPER_ID	$INST_WALLPAPER_ID	A Built-in Variable: INST_WALLPAPER_ID
INTMOD_TYPE_ENVELOPE	$INTMOD_TYPE_ENVELOPE	$INTMOD_TYPE_ENVELOPE	A Built-in Variable: INTMOD_TYPE_ENVELOPE
INTMOD_TYPE_ENV_FOLLOW	$INTMOD_TYPE_ENV_FOLLOW	$INTMOD_TYPE_ENV_FOLLOW	A Built-in Variable: INTMOD_TYPE_ENV_FOLLOW
INTMOD_TYPE_GLIDE	$INTMOD_TYPE_GLIDE	$INTMOD_TYPE_GLIDE	A Built-in Variable: INTMOD_TYPE_GLIDE
INTMOD_TYPE_LFO	$INTMOD_TYPE_LFO	$INTMOD_TYPE_LFO	A Built-in Variable: INTMOD_TYPE_LFO
INTMOD_TYPE_NONE	$INTMOD_TYPE_NONE	$INTMOD_TYPE_NONE	A Built-in Variable: INTMOD_TYPE_NONE
INTMOD_TYPE_STEPMOD	$INTMOD_TYPE_STEPMOD	$INTMOD_TYPE_STEPMOD	A Built-in Variable: INTMOD_TYPE_STEPMOD
KEY_COLOR_BLUE	$KEY_COLOR_BLUE	$KEY_COLOR_BLUE	A Built-in Variable: KEY_COLOR_BLUE
KEY_COLOR_CYAN	$KEY_COLOR_CYAN	$KEY_COLOR_CYAN	A Built-in Variable: KEY_COLOR_CYAN
KEY_COLOR_DEFAULT	$KEY_COLOR_DEFAULT	$KEY_COLOR_DEFAULT	A Built-in Variable: KEY_COLOR_DEFAULT
KEY_COLOR_FUCHSIA	$KEY_COLOR_FUCHSIA	$KEY_COLOR_FUCHSIA	A Built-in Variable: KEY_COLOR_FUCHSIA
KEY_COLOR_GREEN	$KEY_COLOR_GREEN	$KEY_COLOR_GREEN	A Built-in Variable: KEY_COLOR_GREEN
KEY_COLOR_INACTIVE	$KEY_COLOR_INACTIVE	$KEY_COLOR_INACTIVE	A Built-in Variable: KEY_COLOR_INACTIVE
KEY_COLOR_LIGHT_ORANGE	$KEY_COLOR_LIGHT_ORANGE	$KEY_COLOR_LIGHT_ORANGE	A Built-in Variable: KEY_COLOR_LIGHT_ORANGE
KEY_COLOR_LIME	$KEY_COLOR_LIME	$KEY_COLOR_LIME	A Built-in Variable: KEY_COLOR_LIME
KEY_COLOR_MAGENTA	$KEY_COLOR_MAGENTA	$KEY_COLOR_MAGENTA	A Built-in Variable: KEY_COLOR_MAGENTA
KEY_COLOR_MINT	$KEY_COLOR_MINT	$KEY_COLOR_MINT	A Built-in Variable: KEY_COLOR_MINT
KEY_COLOR_NONE	$KEY_COLOR_NONE	$KEY_COLOR_NONE	A Built-in Variable: KEY_COLOR_NONE
KEY_COLOR_ORANGE	$KEY_COLOR_ORANGE	$KEY_COLOR_ORANGE	A Built-in Variable: KEY_COLOR_ORANGE
KEY_COLOR_PLUM	$KEY_COLOR_PLUM	$KEY_COLOR_PLUM	A Built-in Variable: KEY_COLOR_PLUM
KEY_COLOR_PURPLE	$KEY_COLOR_PURPLE	$KEY_COLOR_PURPLE	A Built-in Variable: KEY_COLOR_PURPLE
KEY_COLOR_RED	$KEY_COLOR_RED	$KEY_COLOR_RED	A Built-in Variable: KEY_COLOR_RED
KEY_COLOR_TURQUOISE	$KEY_COLOR_TURQUOISE	$KEY_COLOR_TURQUOISE	A Built-in Variable: KEY_COLOR_TURQUOISE
KEY_COLOR_VIOLET	$KEY_COLOR_VIOLET	$KEY_COLOR_VIOLET	A Built-in Variable: KEY_COLOR_VIOLET
KEY_COLOR_WARM_YELLOW	$KEY_COLOR_WARM_YELLOW	$KEY_COLOR_WARM_YELLOW	A Built-in Variable: KEY_COLOR_WARM_YELLOW
KEY_COLOR_YELLOW	$KEY_COLOR_YELLOW	$KEY_COLOR_YELLOW	A Built-in Variable: KEY_COLOR_YELLOW
KNOB_UNIT_DB	$KNOB_UNIT_DB	$KNOB_UNIT_DB	A Built-in Variable: KNOB_UNIT_DB
KNOB_UNIT_HZ	$KNOB_UNIT_HZ	$KNOB_UNIT_HZ	A Built-in Variable: KNOB_UNIT_HZ
KNOB_UNIT_MS	$KNOB_UNIT_MS	$KNOB_UNIT_MS	A Built-in Variable: KNOB_UNIT_MS
KNOB_UNIT_NONE	$KNOB_UNIT_NONE	$KNOB_UNIT_NONE	A Built-in Variable: KNOB_UNIT_NONE
KNOB_UNIT_OCT	$KNOB_UNIT_OCT	$KNOB_UNIT_OCT	A Built-in Variable: KNOB_UNIT_OCT
KNOB_UNIT_PERCENT	$KNOB_UNIT_PERCENT	$KNOB_UNIT_PERCENT	A Built-in Variable: KNOB_UNIT_PERCENT
KNOB_UNIT_ST	$KNOB_UNIT_ST	$KNOB_UNIT_ST	A Built-in Variable: KNOB_UNIT_ST
KSP_TIMER	$KSP_TIMER	$KSP_TIMER	A Built-in Variable: KSP_TIMER
LFO_TYPE_MULTI	$LFO_TYPE_MULTI	$LFO_TYPE_MULTI	A Built-in Variable: LFO_TYPE_MULTI
LFO_TYPE_RANDO	$LFO_TYPE_RANDO	$LFO_TYPE_RANDO	A Built-in Variable: LFO_TYPE_RANDO
LFO_TYPE_RECTANGLE	$LFO_TYPE_RECTANGLE	$LFO_TYPE_RECTANGLE	A Built-in Variable: LFO_TYPE_RECTANGLE
LFO_TYPE_SAWTOOTH	$LFO_TYPE_SAWTOOTH	$LFO_TYPE_SAWTOOTH	A Built-in Variable: LFO_TYPE_SAWTOOTH
LFO_TYPE_TRIANGLE	$LFO_TYPE_TRIANGLE	$LFO_TYPE_TRIANGLE	A Built-in Variable: LFO_TYPE_TRIANGLE
MARK_1	$MARK_1	$MARK_1	A Built-in Variable: MARK_1
MARK_10	$MARK_10	$MARK_10	A Built-in Variable: MARK_10
MARK_11	$MARK_11	$MARK_11	A Built-in Variable: MARK_11
MARK_12	$MARK_12	$MARK_12	A Built-in Variable: MARK_12
MARK_13	$MARK_13	$MARK_13	A Built-in Variable: MARK_13
MARK_14	$MARK_14	$MARK_14	A Built-in Variable: MARK_14
MARK_15	$MARK_15	$MARK_15	A Built-in Variable: MARK_15
MARK_16	$MARK_16	$MARK_16	A Built-in Variable: MARK_16
MARK_17	$MARK_17	$MARK_17	A Built-in Variable: MARK_17
MARK_18	$MARK_18	$MARK_18	A Built-in Variable: MARK_18
MARK_19	$MARK_19	$MARK_19	A Built-in Variable: MARK_19
MARK_2	$MARK_2	$MARK_2	A Built-in Variable: MARK_2
MARK_20	$MARK_20	$MARK_20	A Built-in Variable: MARK_20
MARK_21	$MARK_21	$MARK_21	A Built-in Variable: MARK_21
MARK_22	$MARK_22	$MARK_22	A Built-in Variable: MARK_22
MARK_23	$MARK_23	$MARK_23	A Built-in Variable: MARK_23
MARK_24	$MARK_24	$MARK_24	A Built-in Variable: MARK_24
MARK_25	$MARK_25	$MARK_25	A Built-in Variable: MARK_25
MARK_26	$MARK_26	$MARK_26	A Built-in Variable: MARK_26
MARK_27	$MARK_27	$MARK_27	A Built-in Variable: MARK_27
MARK_28	$MARK_28	$MARK_28	A Built-in Variable: MARK_28
MARK_3	$MARK_3	$MARK_3	A Built-in Variable: MARK_3
MARK_4	$MARK_4	$MARK_4	A Built-in Variable: MARK_4
MARK_5	$MARK_5	$MARK_5	A Built-in Variable: MARK_5
MARK_6	$MARK_6	$MARK_6	A Built-in Variable: MARK_6
MARK_7	$MARK_7	$MARK_7	A Built-in Variable: MARK_7
MARK_8	$MARK_8	$MARK_8	A Built-in Variable: MARK_8
MARK_9	$MARK_9	$MARK_9	A Built-in Variable: MARK_9
MIDI_BYTE_1	$MIDI_BYTE_1	$MIDI_BYTE_1	A Built-in Variable: MIDI_BYTE_1
MIDI_BYTE_2	$MIDI_BYTE_2	$MIDI_BYTE_2	A Built-in Variable: MIDI_BYTE_2
MIDI_CHANNEL	$MIDI_CHANNEL	$MIDI_CHANNEL	A Built-in Variable: MIDI_CHANNEL
MIDI_COMMAND	$MIDI_COMMAND	$MIDI_COMMAND	A Built-in Variable: MIDI_COMMAND
MIDI_COMMAND_CC	$MIDI_COMMAND_CC	$MIDI_COMMAND_CC	A Built-in Variable: MIDI_COMMAND_CC
MIDI_COMMAND_MONO_AT	$MIDI_COMMAND_MONO_AT	$MIDI_COMMAND_MONO_AT	A Built-in Variable: MIDI_COMMAND_MONO_AT
MIDI_COMMAND_NOTE_OFF	$MIDI_COMMAND_NOTE_OFF	$MIDI_COMMAND_NOTE_OFF	A Built-in Variable: MIDI_COMMAND_NOTE_OFF
MIDI_COMMAND_NOTE_ON	$MIDI_COMMAND_NOTE_ON	$MIDI_COMMAND_NOTE_ON	A Built-in Variable: MIDI_COMMAND_NOTE_ON
MIDI_COMMAND_PITCH_BEND	$MIDI_COMMAND_PITCH_BEND	$MIDI_COMMAND_PITCH_BEND	A Built-in Variable: MIDI_COMMAND_PITCH_BEND
MIDI_COMMAND_POLY_AT	$MIDI_COMMAND_POLY_AT	$MIDI_COMMAND_POLY_AT	A Built-in Variable: MIDI_COMMAND_POLY_AT
MIDI_COMMAND_PROGRAM_CHANGE	$MIDI_COMMAND_PROGRAM_CHANGE	$MIDI_COMMAND_PROGRAM_CHANGE	A Built-in Variable: MIDI_COMMAND_PROGRAM_CHANGE
MIDI_COMMAND_RPN	$MIDI_COMMAND_RPN	$MIDI_COMMAND_RPN	A Built-in Variable: MIDI_COMMAND_RPN
MIDI_COMMAND_NRPN	$MIDI_COMMAND_NRPN	$MIDI_COMMAND_NRPN	A Built-in Variable: MIDI_COMMAND_NRPN
MOD_TARGET_INVERT_SOURCE	$MOD_TARGET_INVERT_SOURCE	$MOD_TARGET_INVERT_SOURCE	A Built-in Variable: MOD_TARGET_INVERT_SOURCE
NI_ASYNC_EXIT_STATUS	$NI_ASYNC_EXIT_STATUS	$NI_ASYNC_EXIT_STATUS	A Built-in Variable: NI_ASYNC_EXIT_STATUS
NI_ASYNC_ID	$NI_ASYNC_ID	$NI_ASYNC_ID	A Built-in Variable: NI_ASYNC_ID
NI_BUS_OFFSET	$NI_BUS_OFFSET	$NI_BUS_OFFSET	A Built-in Variable: NI_BUS_OFFSET
NI_CALLBACK_ID	$NI_CALLBACK_ID	$NI_CALLBACK_ID	A Built-in Variable: NI_CALLBACK_ID
NI_CALLBACK_TYPE	$NI_CALLBACK_TYPE	$NI_CALLBACK_TYPE	A Built-in Variable: NI_CALLBACK_TYPE
NI_CB_TYPE_ASYNC_OUT	$NI_CB_TYPE_ASYNC_OUT	$NI_CB_TYPE_ASYNC_OUT	A Built-in Variable: NI_CB_TYPE_ASYNC_OUT
NI_CB_TYPE_CONTROLLER	$NI_CB_TYPE_CONTROLLER	$NI_CB_TYPE_CONTROLLER	A Built-in Variable: NI_CB_TYPE_CONTROLLER
NI_CB_TYPE_INIT	$NI_CB_TYPE_INIT	$NI_CB_TYPE_INIT	A Built-in Variable: NI_CB_TYPE_INIT
NI_CB_TYPE_LISTENER	$NI_CB_TYPE_LISTENER	$NI_CB_TYPE_LISTENER	A Built-in Variable: NI_CB_TYPE_LISTENER
NI_CB_TYPE_MIDI_IN	$NI_CB_TYPE_MIDI_IN	$NI_CB_TYPE_MIDI_IN	A Built-in Variable: NI_CB_TYPE_MIDI_IN
NI_CB_TYPE_NOTE	$NI_CB_TYPE_NOTE	$NI_CB_TYPE_NOTE	A Built-in Variable: NI_CB_TYPE_NOTE
NI_CB_TYPE_PERSISTENCE_CHANGED	$NI_CB_TYPE_PERSISTENCE_CHANGED	$NI_CB_TYPE_PERSISTENCE_CHANGED	A Built-in Variable: NI_CB_TYPE_PERSISTENCE_CHANGED
NI_CB_TYPE_PGS	$NI_CB_TYPE_PGS	$NI_CB_TYPE_PGS	A Built-in Variable: NI_CB_TYPE_PGS
NI_CB_TYPE_POLY_AT	$NI_CB_TYPE_POLY_AT	$NI_CB_TYPE_POLY_AT	A Built-in Variable: NI_CB_TYPE_POLY_AT
NI_CB_TYPE_RELEASE	$NI_CB_TYPE_RELEASE	$NI_CB_TYPE_RELEASE	A Built-in Variable: NI_CB_TYPE_RELEASE
NI_CB_TYPE_RPN	$NI_CB_TYPE_RPN	$NI_CB_TYPE_RPN	A Built-in Variable: NI_CB_TYPE_RPN
NI_CB_TYPE_NRPN	$NI_CB_TYPE_NRPN	$NI_CB_TYPE_NRPN	A Built-in Variable: NI_CB_TYPE_NRPN
NI_CB_TYPE_UI_CONTROL	$NI_CB_TYPE_UI_CONTROL	$NI_CB_TYPE_UI_CONTROL	A Built-in Variable: NI_CB_TYPE_UI_CONTROL
NI_CB_TYPE_UI_UPDATE	$NI_CB_TYPE_UI_UPDATE	$NI_CB_TYPE_UI_UPDATE	A Built-in Variable: NI_CB_TYPE_UI_UPDATE
NI_FILE_TYPE_ARRAY	$NI_FILE_TYPE_ARRAY	$NI_FILE_TYPE_ARRAY	A Built-in Variable: NI_FILE_TYPE_ARRAY
NI_FILE_TYPE_AUDIO	$NI_FILE_TYPE_AUDIO	$NI_FILE_TYPE_AUDIO	A Built-in Variable: NI_FILE_TYPE_AUDIO
NI_FILE_TYPE_MIDI	$NI_FILE_TYPE_MIDI	$NI_FILE_TYPE_MIDI	A Built-in Variable: NI_FILE_TYPE_MIDI
NI_KEY_TYPE_CONTROL	$NI_KEY_TYPE_CONTROL	$NI_KEY_TYPE_CONTROL	A Built-in Variable: NI_KEY_TYPE_CONTROL
NI_KEY_TYPE_DEFAULT	$NI_KEY_TYPE_DEFAULT	$NI_KEY_TYPE_DEFAULT	A Built-in Variable: NI_KEY_TYPE_DEFAULT
NI_KEY_TYPE_NONE	$NI_KEY_TYPE_NONE	$NI_KEY_TYPE_NONE	A Built-in Variable: NI_KEY_TYPE_NONE
NI_SIGNAL_TIMER_BEAT	$NI_SIGNAL_TIMER_BEAT	$NI_SIGNAL_TIMER_BEAT	A Built-in Variable: NI_SIGNAL_TIMER_BEAT
NI_SIGNAL_TIMER_MS	$NI_SIGNAL_TIMER_MS	$NI_SIGNAL_TIMER_MS	A Built-in Variable: NI_SIGNAL_TIMER_MS
NI_SIGNAL_TRANSP_START	$NI_SIGNAL_TRANSP_START	$NI_SIGNAL_TRANSP_START	A Built-in Variable: NI_SIGNAL_TRANSP_START
NI_SIGNAL_TRANSP_STOP	$NI_SIGNAL_TRANSP_STOP	$NI_SIGNAL_TRANSP_STOP	A Built-in Variable: NI_SIGNAL_TRANSP_STOP
NI_SIGNAL_TYPE	$NI_SIGNAL_TYPE	$NI_SIGNAL_TYPE	A Built-in Variable: NI_SIGNAL_TYPE
NI_SONG_POSITION	$NI_SONG_POSITION	$NI_SONG_POSITION	A Built-in Variable: NI_SONG_POSITION
NI_SYNC_UNIT_16TH	$NI_SYNC_UNIT_16TH	$NI_SYNC_UNIT_16TH	A Built-in Variable: NI_SYNC_UNIT_16TH
NI_SYNC_UNIT_16TH_TRIPLET	$NI_SYNC_UNIT_16TH_TRIPLET	$NI_SYNC_UNIT_16TH_TRIPLET	A Built-in Variable: NI_SYNC_UNIT_16TH_TRIPLET
NI_SYNC_UNIT_256TH	$NI_SYNC_UNIT_256TH	$NI_SYNC_UNIT_256TH	A Built-in Variable: NI_SYNC_UNIT_256TH
NI_SYNC_UNIT_32ND	$NI_SYNC_UNIT_32ND	$NI_SYNC_UNIT_32ND	A Built-in Variable: NI_SYNC_UNIT_32ND
NI_SYNC_UNIT_32ND_TRIPLET	$NI_SYNC_UNIT_32ND_TRIPLET	$NI_SYNC_UNIT_32ND_TRIPLET	A Built-in Variable: NI_SYNC_UNIT_32ND_TRIPLET
NI_SYNC_UNIT_64TH	$NI_SYNC_UNIT_64TH	$NI_SYNC_UNIT_64TH	A Built-in Variable: NI_SYNC_UNIT_64TH
NI_SYNC_UNIT_64TH_TRIPLET	$NI_SYNC_UNIT_64TH_TRIPLET	$NI_SYNC_UNIT_64TH_TRIPLET	A Built-in Variable: NI_SYNC_UNIT_64TH_TRIPLET
NI_SYNC_UNIT_8TH	$NI_SYNC_UNIT_8TH	$NI_SYNC_UNIT_8TH	A Built-in Variable: NI_SYNC_UNIT_8TH
NI_SYNC_UNIT_8TH_TRIPLET	$NI_SYNC_UNIT_8TH_TRIPLET	$NI_SYNC_UNIT_8TH_TRIPLET	A Built-in Variable: NI_SYNC_UNIT_8TH_TRIPLET
NI_SYNC_UNIT_ABS	$NI_SYNC_UNIT_ABS	$NI_SYNC_UNIT_ABS	A Built-in Variable: NI_SYNC_UNIT_ABS
NI_SYNC_UNIT_HALF	$NI_SYNC_UNIT_HALF	$NI_SYNC_UNIT_HALF	A Built-in Variable: NI_SYNC_UNIT_HALF
NI_SYNC_UNIT_HALF_TRIPLET	$NI_SYNC_UNIT_HALF_TRIPLET	$NI_SYNC_UNIT_HALF_TRIPLET	A Built-in Variable: NI_SYNC_UNIT_HALF_TRIPLET
NI_SYNC_UNIT_QUARTER	$NI_SYNC_UNIT_QUARTER	$NI_SYNC_UNIT_QUARTER	A Built-in Variable: NI_SYNC_UNIT_QUARTER
NI_SYNC_UNIT_QUARTER_TRIPLET	$NI_SYNC_UNIT_QUARTER_TRIPLET	$NI_SYNC_UNIT_QUARTER_TRIPLET	A Built-in Variable: NI_SYNC_UNIT_QUARTER_TRIPLET
NI_SYNC_UNIT_WHOLE	$NI_SYNC_UNIT_WHOLE	$NI_SYNC_UNIT_WHOLE	A Built-in Variable: NI_SYNC_UNIT_WHOLE
NI_SYNC_UNIT_WHOLE_TRIPLET	$NI_SYNC_UNIT_WHOLE_TRIPLET	$NI_SYNC_UNIT_WHOLE_TRIPLET	A Built-in Variable: NI_SYNC_UNIT_WHOLE_TRIPLET
NI_SYNC_UNIT_ZONE	$NI_SYNC_UNIT_ZONE	$NI_SYNC_UNIT_ZONE	A Built-in Variable: NI_SYNC_UNIT_ZONE
NI_TRANSPORT_RUNNING	$NI_TRANSPORT_RUNNING	$NI_TRANSPORT_RUNNING	A Built-in Variable: NI_TRANSPORT_RUNNING
NI_VL_TMPRO_STANDARD	$NI_VL_TMPRO_STANDARD	$NI_VL_TMPRO_STANDARD	A Built-in Variable: NI_VL_TMPRO_STANDARD
NI_VL_TMRPO_HQ	$NI_VL_TMRPO_HQ	$NI_VL_TMRPO_HQ	A Built-in Variable: NI_VL_TMRPO_HQ
NOTE_HELD	$NOTE_HELD	$NOTE_HELD	A Built-in Variable: NOTE_HELD
NUM_GROUPS	$NUM_GROUPS	$NUM_GROUPS	A Built-in Variable: NUM_GROUPS
NUM_OUTPUT_CHANNELS	$NUM_OUTPUT_CHANNELS	$NUM_OUTPUT_CHANNELS	A Built-in Variable: NUM_OUTPUT_CHANNELS
NUM_ZONES	$NUM_ZONES	$NUM_ZONES	A Built-in Variable: NUM_ZONES
PLAYED_VOICES_INST	$PLAYED_VOICES_INST	$PLAYED_VOICES_INST	A Built-in Variable: PLAYED_VOICES_INST
PLAYED_VOICES_TOTAL	$PLAYED_VOICES_TOTAL	$PLAYED_VOICES_TOTAL	A Built-in Variable: PLAYED_VOICES_TOTAL
POLY_AT_NUM	$POLY_AT_NUM	$POLY_AT_NUM	A Built-in Variable: POLY_AT_NUM
REF_GROUP_IDX	$REF_GROUP_IDX	$REF_GROUP_IDX	A Built-in Variable: REF_GROUP_IDX
RPN_ADDRESS	$RPN_ADDRESS	$RPN_ADDRESS	A Built-in Variable: RPN_ADDRESS
RPN_VALUE	$RPN_VALUE	$RPN_VALUE	A Built-in Variable: RPN_VALUE
SIGNATURE_DENOM	$SIGNATURE_DENOM	$SIGNATURE_DENOM	A Built-in Variable: SIGNATURE_DENOM
SIGNATURE_NUM	$SIGNATURE_NUM	$SIGNATURE_NUM	A Built-in Variable: SIGNATURE_NUM
START_CRITERIA_AND_NEXT	$START_CRITERIA_AND_NEXT	$START_CRITERIA_AND_NEXT	A Built-in Variable: START_CRITERIA_AND_NEXT
START_CRITERIA_AND_NOT_NEXT	$START_CRITERIA_AND_NOT_NEXT	$START_CRITERIA_AND_NOT_NEXT	A Built-in Variable: START_CRITERIA_AND_NOT_NEXT
START_CRITERIA_CYCLE_RANDOM	$START_CRITERIA_CYCLE_RANDOM	$START_CRITERIA_CYCLE_RANDOM	A Built-in Variable: START_CRITERIA_CYCLE_RANDOM
START_CRITERIA_CYCLE_ROUND_ROBIN	$START_CRITERIA_CYCLE_ROUND_ROBIN	$START_CRITERIA_CYCLE_ROUND_ROBIN	A Built-in Variable: START_CRITERIA_CYCLE_ROUND_ROBIN
START_CRITERIA_NONE	$START_CRITERIA_NONE	$START_CRITERIA_NONE	A Built-in Variable: START_CRITERIA_NONE
START_CRITERIA_ON_CONTROLLER	$START_CRITERIA_ON_CONTROLLER	$START_CRITERIA_ON_CONTROLLER	A Built-in Variable: START_CRITERIA_ON_CONTROLLER
START_CRITERIA_ON_KEY	$START_CRITERIA_ON_KEY	$START_CRITERIA_ON_KEY	A Built-in Variable: START_CRITERIA_ON_KEY
START_CRITERIA_OR_NEXT	$START_CRITERIA_OR_NEXT	$START_CRITERIA_OR_NEXT	A Built-in Variable: START_CRITERIA_OR_NEXT
START_CRITERIA_SLICE_TRIGGER	$START_CRITERIA_SLICE_TRIGGER	$START_CRITERIA_SLICE_TRIGGER	A Built-in Variable: START_CRITERIA_SLICE_TRIGGER
UI_WAVEFORM_TABLE_IS_BIPOLAR	$UI_WAVEFORM_TABLE_IS_BIPOLAR	$UI_WAVEFORM_TABLE_IS_BIPOLAR	A Built-in Variable: UI_WAVEFORM_TABLE_IS_BIPOLAR
UI_WAVEFORM_USE_MIDI_DRAG	$UI_WAVEFORM_USE_MIDI_DRAG	$UI_WAVEFORM_USE_MIDI_DRAG	A Built-in Variable: UI_WAVEFORM_USE_MIDI_DRAG
UI_WAVEFORM_USE_SLICES	$UI_WAVEFORM_USE_SLICES	$UI_WAVEFORM_USE_SLICES	A Built-in Variable: UI_WAVEFORM_USE_SLICES
UI_WAVEFORM_USE_TABLE	$UI_WAVEFORM_USE_TABLE	$UI_WAVEFORM_USE_TABLE	A Built-in Variable: UI_WAVEFORM_USE_TABLE
UI_WF_PROP_FLAGS	$UI_WF_PROP_FLAGS	$UI_WF_PROP_FLAGS	A Built-in Variable: UI_WF_PROP_FLAGS
UI_WF_PROP_MIDI_DRAG_START_NOTE	$UI_WF_PROP_MIDI_DRAG_START_NOTE	$UI_WF_PROP_MIDI_DRAG_START_NOTE	A Built-in Variable: UI_WF_PROP_MIDI_DRAG_START_NOTE
UI_WF_PROP_PLAY_CURSOR	$UI_WF_PROP_PLAY_CURSOR	$UI_WF_PROP_PLAY_CURSOR	A Built-in Variable: UI_WF_PROP_PLAY_CURSOR
UI_WF_PROP_TABLE_IDX_HIGHLIGHT	$UI_WF_PROP_TABLE_IDX_HIGHLIGHT	$UI_WF_PROP_TABLE_IDX_HIGHLIGHT	A Built-in Variable: UI_WF_PROP_TABLE_IDX_HIGHLIGHT
UI_WF_PROP_TABLE_VAL	$UI_WF_PROP_TABLE_VAL	$UI_WF_PROP_TABLE_VAL	A Built-in Variable: UI_WF_PROP_TABLE_VAL
VALUE_EDIT_MODE_NOTE_NAMES	$VALUE_EDIT_MODE_NOTE_NAMES	$VALUE_EDIT_MODE_NOTE_NAMES	A Built-in Variable: VALUE_EDIT_MODE_NOTE_NAMES
VCC_MONO_AT	$VCC_MONO_AT	$VCC_MONO_AT	A Built-in Variable: VCC_MONO_AT
VCC_PITCH_BEND	$VCC_PITCH_BEND	$VCC_PITCH_BEND	A Built-in Variable: VCC_PITCH_BEND
CC	%CC[ ${1:<controller-number>} ]	%CC	A Built-in Variable: CC
CC_TOUCHED	%CC_TOUCHED[ ${1:<controller-number>} ]	%CC_TOUCHED	A Built-in Variable: CC_TOUCHED
GROUPS_AFFECTED	%GROUPS_AFFECTED[ ${1:<index>} ]	%GROUPS_AFFECTED	A Built-in Variable: GROUPS_AFFECTED
GROUPS_SELECTED	%GROUPS_SELECTED[ ${1:<index>} ]	%GROUPS_SELECTED	A Built-in Variable: GROUPS_SELECTED
KEY_DOWN	%KEY_DOWN[ ${1:<note-number>} ]	%KEY_DOWN	A Built-in Variable: KEY_DOWN
KEY_DOWN_OCT	%KEY_DOWN_OCT[ ${1:<note-number>} ]	%KEY_DOWN_OCT	A Built-in Variable: KEY_DOWN_OCT
NOTE_DURATION	%NOTE_DURATION[ ${1:<note-number>} ]	%NOTE_DURATION	A Built-in Variable: NOTE_DURATION
POLY_AT	%POLY_AT[ ${1:<note-number>} ]	%POLY_AT	A Built-in Variable: POLY_AT
NI_MATH_E	~NI_MATH_E	~NI_MATH_E	A Built-in Variable: NI_MATH_E
NI_MATH_PI	~NI_MATH_PI	~NI_MATH_PI	A Built-in Variable: NI_MATH_PI